Store Number,NSW2 CONSOLE - QTY,NSW2 MARIO KART WLD - QTY,Total Estimate: In-store Launch (QTY) ,Time Zone,Event Type
1,2,17,19,CST,Morning Event- June 5
2,7,11,18,CST,Morning Event- June 5
3,4,11,15,EST,Morning Event- June 5
4,7,16,23,CST,Morning Event- June 5
5,3,11,14,CST,Morning Event- June 5
7,2,11,13,CST,Morning Event- June 5
8,6,5,11,CST,Morning Event- June 5
9,7,11,18,CST,Morning Event- June 5
10,11,11,22,CST,Morning Event- June 5
11,15,11,26,CST,Morning Event- June 5
12,4,16,20,CST,Morning Event- June 5
13,6,6,12,CST,Morning Event- June 5
14,16,11,27,CST,Morning Event- June 5
15,13,11,24,CST,Morning Event- June 5
16,8,11,19,CST,Morning Event- June 5
17,9,11,20,CST,Morning Event- June 5
18,3,5,8,CST,Morning Event- June 5
19,16,18,34,CST,Morning Event- June 5
20,8,6,14,CST,Morning Event- June 5
21,8,17,25,CST,Morning Event- June 5
22,16,11,27,CST,Morning Event- June 5
23,6,6,12,CST,Morning Event- June 5
24,2,5,7,CST,Morning Event- June 5
25,9,11,20,CST,Morning Event- June 5
26,5,11,16,CST,Morning Event- June 5
27,8,5,13,CST,Morning Event- June 5
28,6,6,12,CST,Morning Event- June 5
29,5,11,16,CST,Morning Event- June 5
30,6,6,12,CST,Morning Event- June 5
31,9,11,20,CST,Morning Event- June 5
32,8,5,13,CST,Morning Event- June 5
33,3,5,8,CST,Morning Event- June 5
34,6,6,12,CST,Morning Event- June 5
35,6,16,22,CST,Morning Event- June 5
36,9,11,20,CST,Morning Event- June 5
37,7,11,18,CST,Morning Event- June 5
38,8,5,13,CST,Morning Event- June 5
39,3,5,8,CST,Morning Event- June 5
40,8,11,19,CST,Morning Event- June 5
41,9,17,26,CST,Morning Event- June 5
42,4,5,9,CST,Morning Event- June 5
43,3,11,14,CST,Morning Event- June 5
44,2,5,7,CST,Morning Event- June 5
45,2,11,13,CST,Morning Event- June 5
46,10,11,21,CST,Morning Event- June 5
47,6,6,12,CST,Morning Event- June 5
48,5,5,10,CST,Morning Event- June 5
49,5,5,10,CST,Morning Event- June 5
50,4,5,9,CST,Morning Event- June 5
51,2,5,7,CST,Morning Event- June 5
52,5,11,16,CST,Morning Event- June 5
54,2,11,13,CST,Morning Event- June 5
55,3,5,8,CST,Morning Event- June 5
56,2,5,7,CST,Morning Event- June 5
57,5,5,10,CST,Morning Event- June 5
58,14,18,32,CST,Morning Event- June 5
59,8,16,24,CST,Morning Event- June 5
60,5,6,11,CST,Morning Event- June 5
61,11,16,27,CST,Morning Event- June 5
62,6,5,11,CST,Morning Event- June 5
63,4,5,9,CST,Morning Event- June 5
64,3,5,8,CST,Morning Event- June 5
65,10,11,21,CST,Morning Event- June 5
66,5,5,10,CST,Morning Event- June 5
67,7,5,12,CST,Morning Event- June 5
68,3,5,8,CST,Morning Event- June 5
69,3,17,20,CST,Morning Event- June 5
70,3,5,8,CST,Morning Event- June 5
71,8,5,13,CST,Morning Event- June 5
72,10,11,21,CST,Morning Event- June 5
73,2,5,7,CST,Morning Event- June 5
74,4,5,9,CST,Morning Event- June 5
75,4,11,15,CST,Morning Event- June 5
76,6,5,11,CST,Morning Event- June 5
77,3,6,9,CST,Morning Event- June 5
78,4,6,10,CST,Morning Event- June 5
79,3,11,14,CST,Morning Event- June 5
80,3,6,9,CST,Morning Event- June 5
81,3,5,8,CST,Morning Event- June 5
82,4,5,9,CST,Morning Event- June 5
83,5,5,10,CST,Morning Event- June 5
85,6,11,17,CST,Morning Event- June 5
86,5,11,16,CST,Morning Event- June 5
87,8,5,13,CST,Morning Event- June 5
88,8,5,13,CST,Morning Event- June 5
89,9,11,20,CST,Morning Event- June 5
90,8,6,14,CST,Morning Event- June 5
91,5,5,10,CST,Morning Event- June 5
92,7,5,12,CST,Morning Event- June 5
93,4,6,10,CST,Morning Event- June 5
94,6,11,17,CST,Morning Event- June 5
95,9,11,20,CST,Morning Event- June 5
96,5,11,16,CST,Morning Event- June 5
97,2,5,7,CST,Morning Event- June 5
98,2,5,7,CST,Morning Event- June 5
99,6,6,12,CST,Morning Event- June 5
100,3,23,26,CST,Morning Event- June 5
101,16,17,33,CST,Morning Event- June 5
102,5,5,10,CST,Morning Event- June 5
103,16,17,33,CST,Morning Event- June 5
104,6,6,12,CST,Morning Event- June 5
105,3,11,14,CST,Morning Event- June 5
106,3,5,8,CST,Morning Event- June 5
107,2,5,7,CST,Morning Event- June 5
108,6,5,11,CST,Morning Event- June 5
109,6,5,11,CST,Morning Event- June 5
110,4,11,15,EST,Morning Event- June 5
111,2,5,7,CST,Morning Event- June 5
112,6,11,17,CST,Morning Event- June 5
113,8,11,19,CST,Morning Event- June 5
114,3,5,8,CST,Morning Event- June 5
115,5,10,15,CST,Morning Event- June 5
116,5,5,10,CST,Morning Event- June 5
117,3,5,8,CST,Morning Event- June 5
118,8,5,13,CST,Morning Event- June 5
119,10,11,21,CST,Morning Event- June 5
120,6,5,11,CST,Morning Event- June 5
121,7,5,12,CST,Morning Event- June 5
122,5,5,10,CST,Morning Event- June 5
123,8,5,13,CST,Morning Event- June 5
124,5,5,10,CST,Morning Event- June 5
125,7,11,18,CST,Morning Event- June 5
126,4,5,9,CST,Morning Event- June 5
127,6,5,11,CST,Morning Event- June 5
128,6,11,17,CST,Morning Event- June 5
129,12,11,23,CST,Morning Event- June 5
130,14,11,25,CST,Morning Event- June 5
131,7,11,18,CST,Morning Event- June 5
132,4,5,9,CST,Morning Event- June 5
133,5,5,10,CST,Morning Event- June 5
134,7,11,18,CST,Morning Event- June 5
135,10,11,21,CST,Morning Event- June 5
136,3,5,8,CST,Morning Event- June 5
137,6,11,17,CST,Morning Event- June 5
138,6,11,17,CST,Morning Event- June 5
139,6,5,11,CST,Morning Event- June 5
140,7,16,23,CST,Morning Event- June 5
141,4,11,15,CST,Morning Event- June 5
143,4,5,9,CST,Morning Event- June 5
144,5,16,21,CST,Morning Event- June 5
145,10,5,15,CST,Morning Event- June 5
146,6,5,11,CST,Morning Event- June 5
147,6,6,12,CST,Morning Event- June 5
148,14,11,25,CST,Morning Event- June 5
149,4,5,9,CST,Morning Event- June 5
150,8,11,19,CST,Morning Event- June 5
151,14,11,25,CST,Morning Event- June 5
152,6,11,17,CST,Morning Event- June 5
153,7,5,12,CST,Morning Event- June 5
154,6,11,17,EST,Morning Event- June 5
155,2,5,7,CST,Morning Event- June 5
157,8,17,25,CST,Morning Event- June 5
158,5,5,10,CST,Morning Event- June 5
159,6,11,17,CST,Morning Event- June 5
160,7,5,12,CST,Morning Event- June 5
161,2,5,7,CST,Morning Event- June 5
162,5,5,10,CST,Morning Event- June 5
163,14,11,25,CST,Morning Event- June 5
164,6,6,12,CST,Morning Event- June 5
165,11,11,22,CST,Morning Event- June 5
166,3,5,8,CST,Morning Event- June 5
167,3,5,8,CST,Morning Event- June 5
168,4,16,20,CST,Morning Event- June 5
169,4,5,9,CST,Morning Event- June 5
170,8,5,13,CST,Morning Event- June 5
171,9,5,14,CST,Morning Event- June 5
172,2,11,13,CST,Morning Event- June 5
173,6,5,11,CST,Morning Event- June 5
174,3,11,14,EST,Morning Event- June 5
175,6,5,11,CST,Morning Event- June 5
176,4,5,9,CST,Morning Event- June 5
177,9,11,20,CST,Morning Event- June 5
178,6,5,11,CST,Morning Event- June 5
179,4,11,15,CST,Morning Event- June 5
180,7,6,13,CST,Morning Event- June 5
181,6,5,11,CST,Morning Event- June 5
182,9,5,14,CST,Morning Event- June 5
183,5,5,10,CST,Morning Event- June 5
184,2,16,18,CST,Morning Event- June 5
185,3,11,14,CST,Morning Event- June 5
186,4,6,10,CST,Morning Event- June 5
188,2,17,19,CST,Morning Event- June 5
189,12,11,23,CST,Morning Event- June 5
190,2,6,8,CST,Morning Event- June 5
192,3,16,19,CST,Morning Event- June 5
194,6,11,17,CST,Morning Event- June 5
195,3,11,14,CST,Morning Event- June 5
196,11,11,22,CST,Morning Event- June 5
197,8,11,19,CST,Morning Event- June 5
198,6,5,11,CST,Morning Event- June 5
199,6,6,12,CST,Morning Event- June 5
200,8,11,19,CST,Morning Event- June 5
201,4,11,15,CST,Morning Event- June 5
202,4,5,9,CST,Morning Event- June 5
203,6,5,11,CST,Morning Event- June 5
204,6,6,12,CST,Morning Event- June 5
205,8,5,13,CST,Morning Event- June 5
206,5,6,11,CST,Morning Event- June 5
207,2,5,7,CST,Morning Event- June 5
209,5,5,10,CST,Morning Event- June 5
210,6,5,11,CST,Morning Event- June 5
211,4,5,9,CST,Morning Event- June 5
212,4,11,15,CST,Morning Event- June 5
213,3,11,14,CST,Morning Event- June 5
214,7,6,13,CST,Morning Event- June 5
216,10,16,26,CST,Morning Event- June 5
217,2,5,7,CST,Morning Event- June 5
218,6,5,11,CST,Morning Event- June 5
219,5,11,16,CST,Morning Event- June 5
220,3,16,19,CST,Morning Event- June 5
221,2,11,13,CST,Morning Event- June 5
222,4,5,9,CST,Morning Event- June 5
224,7,11,18,CST,Morning Event- June 5
225,3,5,8,CST,Morning Event- June 5
226,10,5,15,CST,Morning Event- June 5
227,6,5,11,CST,Morning Event- June 5
228,6,11,17,CST,Morning Event- June 5
229,3,5,8,CST,Morning Event- June 5
230,5,5,10,CST,Morning Event- June 5
231,14,16,30,CST,Morning Event- June 5
232,5,5,10,CST,Morning Event- June 5
233,8,5,13,CST,Morning Event- June 5
234,2,11,13,CST,Morning Event- June 5
236,3,5,8,CST,Morning Event- June 5
237,5,11,16,CST,Morning Event- June 5
238,7,5,12,CST,Morning Event- June 5
239,3,5,8,CST,Morning Event- June 5
240,5,5,10,CST,Morning Event- June 5
242,7,5,12,CST,Morning Event- June 5
243,5,11,16,CST,Morning Event- June 5
244,4,5,9,CST,Morning Event- June 5
246,6,5,11,CST,Morning Event- June 5
247,2,5,7,CST,Morning Event- June 5
248,7,6,13,CST,Morning Event- June 5
249,6,11,17,CST,Morning Event- June 5
250,4,5,9,CST,Morning Event- June 5
251,4,6,10,CST,Morning Event- June 5
252,6,5,11,CST,Morning Event- June 5
253,7,11,18,CST,Morning Event- June 5
254,7,5,12,CST,Morning Event- June 5
256,4,17,21,CST,Morning Event- June 5
257,6,5,11,CST,Morning Event- June 5
258,15,11,26,CST,Morning Event- June 5
259,5,11,16,CST,Morning Event- June 5
260,5,11,16,CST,Morning Event- June 5
261,7,11,18,CST,Morning Event- June 5
262,5,11,16,CST,Morning Event- June 5
264,9,17,26,CST,Morning Event- June 5
265,6,11,17,CST,Morning Event- June 5
266,12,10,22,CST,Morning Event- June 5
267,2,6,8,CST,Morning Event- June 5
268,6,6,12,CST,Morning Event- June 5
269,6,11,17,CST,Morning Event- June 5
271,4,5,9,CST,Morning Event- June 5
272,2,11,13,CST,Morning Event- June 5
273,9,10,19,CST,Morning Event- June 5
274,5,5,10,CST,Morning Event- June 5
275,11,11,22,CST,Morning Event- June 5
276,2,5,7,CST,Morning Event- June 5
277,5,11,16,CST,Morning Event- June 5
278,2,11,13,CST,Morning Event- June 5
279,3,5,8,CST,Morning Event- June 5
280,3,5,8,CST,Morning Event- June 5
281,9,5,14,CST,Morning Event- June 5
282,5,11,16,CST,Morning Event- June 5
283,6,5,11,CST,Morning Event- June 5
284,3,11,14,CST,Morning Event- June 5
285,6,11,17,CST,Morning Event- June 5
286,2,6,8,CST,Morning Event- June 5
287,12,11,23,CST,Morning Event- June 5
288,4,5,9,CST,Morning Event- June 5
289,5,5,10,CST,Morning Event- June 5
290,2,5,7,CST,Morning Event- June 5
292,6,6,12,CST,Morning Event- June 5
293,6,5,11,CST,Morning Event- June 5
294,3,6,9,CST,Morning Event- June 5
295,4,6,10,CST,Morning Event- June 5
296,6,5,11,CST,Morning Event- June 5
297,6,16,22,CST,Morning Event- June 5
298,14,11,25,CST,Morning Event- June 5
299,5,16,21,CST,Morning Event- June 5
300,4,5,9,CST,Morning Event- June 5
301,8,11,19,CST,Morning Event- June 5
302,4,5,9,CST,Morning Event- June 5
303,4,5,9,CST,Morning Event- June 5
304,7,16,23,CST,Morning Event- June 5
305,4,5,9,CST,Morning Event- June 5
306,5,11,16,CST,Morning Event- June 5
307,6,11,17,CST,Morning Event- June 5
308,7,11,18,CST,Morning Event- June 5
309,6,6,12,CST,Morning Event- June 5
310,7,5,12,CST,Morning Event- June 5
311,4,5,9,CST,Morning Event- June 5
312,3,5,8,CST,Morning Event- June 5
313,6,11,17,CST,Morning Event- June 5
314,6,6,12,CST,Morning Event- June 5
315,10,11,21,CST,Morning Event- June 5
316,7,16,23,CST,Morning Event- June 5
317,2,5,7,CST,Morning Event- June 5
318,2,5,7,CST,Morning Event- June 5
319,5,11,16,CST,Morning Event- June 5
320,5,5,10,CST,Morning Event- June 5
321,5,5,10,CST,Morning Event- June 5
322,6,11,17,CST,Morning Event- June 5
323,2,5,7,CST,Morning Event- June 5
324,4,5,9,CST,Morning Event- June 5
325,2,5,7,CST,Morning Event- June 5
326,5,5,10,CST,Morning Event- June 5
328,2,6,8,CST,Morning Event- June 5
329,6,6,12,CST,Morning Event- June 5
330,10,11,21,CST,Morning Event- June 5
331,6,11,17,CST,Morning Event- June 5
332,6,11,17,CST,Morning Event- June 5
333,4,5,9,CST,Morning Event- June 5
334,6,5,11,CST,Morning Event- June 5
335,6,11,17,CST,Morning Event- June 5
336,6,5,11,CST,Morning Event- June 5
337,3,5,8,CST,Morning Event- June 5
338,3,5,8,CST,Morning Event- June 5
339,5,5,10,CST,Morning Event- June 5
340,9,5,14,CST,Morning Event- June 5
341,5,5,10,CST,Morning Event- June 5
342,3,5,8,CST,Morning Event- June 5
343,2,6,8,CST,Morning Event- June 5
344,9,5,14,CST,Morning Event- June 5
345,11,11,22,CST,Morning Event- June 5
346,6,5,11,CST,Morning Event- June 5
347,3,5,8,CST,Morning Event- June 5
348,6,6,12,CST,Morning Event- June 5
350,6,5,11,CST,Morning Event- June 5
351,3,11,14,CST,Morning Event- June 5
352,5,5,10,CST,Morning Event- June 5
353,7,5,12,CST,Morning Event- June 5
354,4,5,9,CST,Morning Event- June 5
355,2,11,13,CST,Morning Event- June 5
356,5,6,11,CST,Morning Event- June 5
357,2,5,7,CST,Morning Event- June 5
358,4,5,9,CST,Morning Event- June 5
359,6,17,23,CST,Morning Event- June 5
360,6,5,11,CST,Morning Event- June 5
361,6,11,17,CST,Morning Event- June 5
362,4,5,9,CST,Morning Event- June 5
363,7,6,13,CST,Morning Event- June 5
364,10,5,15,CST,Morning Event- June 5
365,5,11,16,CST,Morning Event- June 5
366,3,11,14,EST,Morning Event- June 5
368,9,5,14,CST,Morning Event- June 5
369,9,5,14,CST,Morning Event- June 5
370,5,5,10,CST,Morning Event- June 5
371,5,11,16,CST,Morning Event- June 5
372,15,11,26,CST,Morning Event- June 5
373,3,5,8,CST,Morning Event- June 5
374,2,11,13,CST,Morning Event- June 5
375,5,5,10,CST,Morning Event- June 5
376,6,11,17,CST,Morning Event- June 5
378,5,5,10,CST,Morning Event- June 5
379,6,11,17,CST,Morning Event- June 5
381,8,16,24,CST,Morning Event- June 5
382,6,6,12,CST,Morning Event- June 5
383,8,11,19,CST,Morning Event- June 5
384,6,6,12,CST,Morning Event- June 5
385,5,5,10,CST,Morning Event- June 5
386,3,5,8,CST,Morning Event- June 5
387,5,5,10,CST,Morning Event- June 5
388,11,11,22,CST,Morning Event- June 5
389,3,11,14,CST,Morning Event- June 5
390,6,5,11,CST,Morning Event- June 5
391,6,6,12,CST,Morning Event- June 5
392,7,11,18,CST,Morning Event- June 5
393,6,11,17,CST,Morning Event- June 5
394,2,5,7,CST,Morning Event- June 5
395,4,18,22,CST,Morning Event- June 5
396,5,11,16,EST,Morning Event- June 5
397,3,18,21,CST,Morning Event- June 5
398,10,11,21,CST,Morning Event- June 5
399,6,16,22,CST,Morning Event- June 5
400,2,17,19,CST,Morning Event- June 5
401,2,5,7,CST,Morning Event- June 5
402,6,5,11,CST,Morning Event- June 5
403,8,5,13,CST,Morning Event- June 5
404,2,11,13,CST,Morning Event- June 5
405,7,11,18,CST,Morning Event- June 5
406,3,11,14,CST,Morning Event- June 5
407,2,17,19,CST,Morning Event- June 5
408,2,11,13,CST,Morning Event- June 5
409,2,5,7,CST,Morning Event- June 5
410,7,11,18,CST,Morning Event- June 5
411,5,5,10,CST,Morning Event- June 5
412,7,11,18,CST,Morning Event- June 5
413,7,5,12,CST,Morning Event- June 5
414,2,6,8,CST,Morning Event- June 5
415,6,5,11,CST,Morning Event- June 5
416,6,11,17,CST,Morning Event- June 5
417,9,11,20,CST,Morning Event- June 5
418,4,5,9,CST,Morning Event- June 5
419,9,5,14,CST,Morning Event- June 5
420,5,11,16,CST,Morning Event- June 5
421,5,11,16,CST,Morning Event- June 5
422,3,5,8,CST,Morning Event- June 5
423,5,16,21,CST,Morning Event- June 5
424,2,6,8,CST,Morning Event- June 5
425,5,5,10,CST,Morning Event- June 5
426,6,5,11,CST,Morning Event- June 5
427,11,11,22,CST,Morning Event- June 5
428,6,5,11,CST,Morning Event- June 5
429,5,11,16,CST,Morning Event- June 5
430,4,6,10,CST,Morning Event- June 5
431,2,11,13,CST,Morning Event- June 5
432,6,5,11,CST,Morning Event- June 5
433,6,5,11,CST,Morning Event- June 5
434,4,11,15,CST,Morning Event- June 5
435,2,6,8,CST,Morning Event- June 5
436,6,5,11,CST,Morning Event- June 5
437,6,5,11,CST,Morning Event- June 5
438,3,5,8,CST,Morning Event- June 5
440,8,5,13,CST,Morning Event- June 5
442,5,11,16,CST,Morning Event- June 5
443,2,5,7,CST,Morning Event- June 5
444,4,11,15,CST,Morning Event- June 5
445,6,11,17,CST,Morning Event- June 5
446,5,5,10,CST,Morning Event- June 5
447,16,17,33,CST,Morning Event- June 5
448,5,5,10,CST,Morning Event- June 5
449,6,6,12,CST,Morning Event- June 5
450,6,5,11,CST,Morning Event- June 5
451,4,11,15,CST,Morning Event- June 5
452,6,16,22,CST,Morning Event- June 5
453,5,5,10,CST,Morning Event- June 5
454,2,5,7,CST,Morning Event- June 5
456,2,17,19,CST,Morning Event- June 5
457,6,11,17,CST,Morning Event- June 5
458,8,6,14,CST,Morning Event- June 5
459,4,11,15,EST,Morning Event- June 5
461,12,23,35,CST,Morning Event- June 5
462,6,11,17,CST,Morning Event- June 5
463,10,11,21,CST,Morning Event- June 5
464,5,16,21,CST,Morning Event- June 5
465,9,11,20,CST,Morning Event- June 5
466,4,5,9,CST,Morning Event- June 5
467,4,11,15,CST,Morning Event- June 5
468,3,11,14,CST,Morning Event- June 5
469,4,5,9,CST,Morning Event- June 5
470,2,11,13,CST,Morning Event- June 5
471,6,5,11,CST,Morning Event- June 5
472,5,16,21,CST,Morning Event- June 5
473,5,5,10,CST,Morning Event- June 5
475,5,11,16,CST,Morning Event- June 5
476,10,5,15,CST,Morning Event- June 5
477,5,5,10,EST,Morning Event- June 5
478,5,5,10,CST,Morning Event- June 5
479,7,11,18,CST,Morning Event- June 5
480,5,5,10,CST,Morning Event- June 5
481,2,11,13,CST,Morning Event- June 5
482,6,5,11,CST,Morning Event- June 5
483,2,6,8,CST,Morning Event- June 5
484,2,11,13,CST,Morning Event- June 5
485,3,5,8,CST,Morning Event- June 5
486,6,5,11,CST,Morning Event- June 5
488,4,5,9,EST,Morning Event- June 5
489,6,5,11,CST,Morning Event- June 5
490,4,11,15,CST,Morning Event- June 5
491,5,16,21,CST,Morning Event- June 5
492,11,11,22,EST,Morning Event- June 5
493,6,5,11,EST,Morning Event- June 5
494,4,11,15,EST,Morning Event- June 5
495,7,16,23,CST,Morning Event- June 5
497,2,11,13,EST,Morning Event- June 5
498,4,5,9,CST,Morning Event- June 5
499,14,17,31,CST,Morning Event- June 5
501,10,11,21,CST,Morning Event- June 5
502,8,5,13,CST,Morning Event- June 5
503,5,5,10,CST,Morning Event- June 5
504,6,6,12,CST,Morning Event- June 5
505,8,6,14,CST,Morning Event- June 5
506,4,5,9,CST,Morning Event- June 5
507,2,5,7,EST,Morning Event- June 5
508,8,11,19,CST,Morning Event- June 5
510,2,11,13,EST,Morning Event- June 5
511,3,11,14,EST,Morning Event- June 5
513,9,11,20,CST,Morning Event- June 5
514,6,11,17,EST,Morning Event- June 5
515,10,11,21,EST,Morning Event- June 5
516,6,5,11,CST,Morning Event- June 5
517,6,11,17,CST,Morning Event- June 5
518,6,11,17,EST,Morning Event- June 5
519,6,5,11,EST,Morning Event- June 5
520,5,11,16,EST,Morning Event- June 5
521,6,5,11,CST,Morning Event- June 5
522,4,6,10,CST,Morning Event- June 5
523,6,5,11,CST,Morning Event- June 5
524,2,5,7,CST,Morning Event- June 5
526,5,5,10,EST,Morning Event- June 5
527,4,6,10,CST,Morning Event- June 5
528,5,11,16,EST,Morning Event- June 5
529,6,11,17,CST,Morning Event- June 5
530,10,11,21,CST,Morning Event- June 5
531,2,11,13,CST,Morning Event- June 5
532,2,11,13,CST,Morning Event- June 5
533,5,11,16,CST,Morning Event- June 5
535,6,17,23,CST,Morning Event- June 5
536,6,11,17,CST,Morning Event- June 5
537,4,18,22,CST,Morning Event- June 5
538,3,11,14,EST,Morning Event- June 5
539,4,5,9,CST,Morning Event- June 5
540,8,5,13,CST,Morning Event- June 5
541,4,11,15,CST,Morning Event- June 5
542,4,11,15,CST,Morning Event- June 5
543,6,5,11,CST,Morning Event- June 5
544,2,11,13,CST,Morning Event- June 5
545,5,5,10,EST,Morning Event- June 5
546,4,11,15,CST,Morning Event- June 5
547,4,11,15,EST,Morning Event- June 5
548,2,6,8,EST,Morning Event- June 5
550,2,5,7,CST,Morning Event- June 5
551,7,11,18,EST,Morning Event- June 5
552,6,5,11,EST,Morning Event- June 5
553,6,11,17,CST,Morning Event- June 5
554,5,23,28,CST,Morning Event- June 5
555,10,11,21,EST,Morning Event- June 5
556,14,11,25,EST,Morning Event- June 5
557,8,11,19,CST,Morning Event- June 5
558,5,11,16,CST,Morning Event- June 5
559,2,16,18,CST,Morning Event- June 5
560,2,11,13,CST,Morning Event- June 5
561,5,5,10,CST,Morning Event- June 5
562,6,5,11,CST,Morning Event- June 5
563,6,11,17,EST,Morning Event- June 5
564,5,11,16,CST,Morning Event- June 5
565,9,11,20,CST,Morning Event- June 5
566,5,5,10,CST,Morning Event- June 5
567,5,5,10,CST,Morning Event- June 5
568,6,5,11,CST,Morning Event- June 5
569,10,11,21,CST,Morning Event- June 5
571,4,11,15,EST,Morning Event- June 5
572,9,11,20,CST,Morning Event- June 5
573,2,11,13,CST,Morning Event- June 5
574,4,11,15,EST,Morning Event- June 5
575,5,11,16,EST,Morning Event- June 5
576,4,11,15,CST,Morning Event- June 5
577,4,11,15,CST,Morning Event- June 5
578,7,23,30,EST,Morning Event- June 5
579,4,11,15,EST,Morning Event- June 5
580,3,11,14,EST,Morning Event- June 5
581,6,11,17,CST,Morning Event- June 5
582,4,11,15,EST,Morning Event- June 5
583,5,6,11,EST,Morning Event- June 5
584,6,11,17,EST,Morning Event- June 5
585,6,11,17,EST,Morning Event- June 5
586,2,11,13,EST,Morning Event- June 5
587,5,6,11,CST,Morning Event- June 5
588,5,11,16,EST,Morning Event- June 5
589,2,6,8,EST,Morning Event- June 5
590,4,11,15,CST,Morning Event- June 5
591,5,5,10,EST,Morning Event- June 5
592,5,11,16,CST,Morning Event- June 5
593,12,11,23,EST,Morning Event- June 5
594,4,5,9,EST,Morning Event- June 5
595,3,18,21,CST,Morning Event- June 5
596,6,5,11,CST,Morning Event- June 5
598,2,11,13,CST,Morning Event- June 5
599,2,11,13,EST,Morning Event- June 5
600,7,11,18,CST,Morning Event- June 5
601,2,11,13,CST,Morning Event- June 5
602,5,11,16,CST,Morning Event- June 5
603,2,11,13,CST,Morning Event- June 5
604,4,11,15,CST,Morning Event- June 5
605,5,6,11,EST,Morning Event- June 5
606,6,5,11,EST,Morning Event- June 5
608,10,23,33,CST,Morning Event- June 5
609,6,11,17,CST,Morning Event- June 5
610,7,11,18,CST,Morning Event- June 5
612,6,6,12,CST,Morning Event- June 5
613,3,11,14,EST,Morning Event- June 5
614,3,11,14,EST,Morning Event- June 5
615,2,11,13,EST,Morning Event- June 5
616,6,5,11,EST,Morning Event- June 5
617,5,5,10,EST,Morning Event- June 5
618,3,11,14,EST,Morning Event- June 5
619,9,11,20,EST,Morning Event- June 5
620,2,11,13,EST,Morning Event- June 5
621,3,5,8,EST,Morning Event- June 5
622,3,11,14,CST,Morning Event- June 5
623,4,11,15,EST,Morning Event- June 5
624,6,5,11,EST,Morning Event- June 5
625,5,5,10,EST,Morning Event- June 5
626,10,5,15,CST,Morning Event- June 5
627,8,5,13,EST,Morning Event- June 5
628,2,11,13,EST,Morning Event- June 5
629,3,5,8,EST,Morning Event- June 5
630,6,11,17,EST,Morning Event- June 5
631,2,11,13,EST,Morning Event- June 5
632,4,5,9,EST,Morning Event- June 5
633,6,5,11,CST,Morning Event- June 5
634,6,6,12,EST,Morning Event- June 5
635,2,11,13,EST,Morning Event- June 5
636,5,5,10,CST,Morning Event- June 5
637,4,5,9,CST,Morning Event- June 5
638,7,11,18,EST,Morning Event- June 5
639,9,11,20,EST,Morning Event- June 5
640,6,11,17,EST,Morning Event- June 5
641,4,11,15,EST,Morning Event- June 5
642,5,5,10,EST,Morning Event- June 5
643,4,11,15,EST,Morning Event- June 5
644,6,6,12,EST,Morning Event- June 5
645,7,11,18,CST,Morning Event- June 5
646,6,5,11,CST,Morning Event- June 5
647,6,5,11,CST,Morning Event- June 5
648,5,11,16,CST,Morning Event- June 5
649,3,11,14,EST,Morning Event- June 5
651,6,11,17,CST,Morning Event- June 5
652,15,11,26,CST,Morning Event- June 5
653,8,11,19,CST,Morning Event- June 5
655,9,11,20,CST,Morning Event- June 5
656,5,11,16,CST,Morning Event- June 5
657,9,16,25,CST,Morning Event- June 5
658,4,11,15,EST,Morning Event- June 5
659,4,11,15,CST,Morning Event- June 5
660,9,11,20,CST,Morning Event- June 5
661,6,11,17,CST,Morning Event- June 5
662,4,16,20,CST,Morning Event- June 5
663,7,11,18,EST,Morning Event- June 5
664,15,11,26,CST,Morning Event- June 5
665,9,11,20,EST,Morning Event- June 5
666,9,11,20,EST,Morning Event- June 5
667,8,11,19,CST,Morning Event- June 5
668,7,11,18,CST,Morning Event- June 5
669,3,11,14,EST,Morning Event- June 5
670,8,23,31,CST,Morning Event- June 5
671,5,11,16,CST,Morning Event- June 5
672,5,17,22,EST,Morning Event- June 5
673,2,16,18,CST,Morning Event- June 5
674,5,16,21,CST,Morning Event- June 5
675,6,6,12,CST,Morning Event- June 5
676,6,11,17,EST,Morning Event- June 5
677,11,11,22,CST,Morning Event- June 5
678,5,11,16,EST,Morning Event- June 5
680,6,11,17,EST,Morning Event- June 5
681,8,11,19,CST,Morning Event- June 5
682,2,16,18,CST,Morning Event- June 5
683,11,11,22,CST,Morning Event- June 5
684,7,11,18,CST,Morning Event- June 5
685,6,17,23,EST,Morning Event- June 5
686,6,5,11,EST,Morning Event- June 5
687,6,16,22,CST,Morning Event- June 5
688,6,6,12,CST,Morning Event- June 5
689,15,23,38,EST,Morning Event- June 5
690,3,11,14,EST,Morning Event- June 5
691,14,21,35,CST,Morning Event- June 5
692,4,11,15,EST,Morning Event- June 5
693,10,5,15,EST,Morning Event- June 5
694,6,11,17,CST,Morning Event- June 5
695,6,5,11,CST,Morning Event- June 5
696,3,5,8,EST,Morning Event- June 5
697,6,17,23,EST,Morning Event- June 5
698,3,11,14,EST,Morning Event- June 5
699,7,11,18,CST,Morning Event- June 5
700,3,5,8,CST,Morning Event- June 5
701,2,11,13,CST,Morning Event- June 5
702,6,11,17,EST,Morning Event- June 5
703,4,11,15,CST,Morning Event- June 5
705,2,11,13,EST,Morning Event- June 5
706,6,11,17,EST,Morning Event- June 5
707,4,5,9,CST,Morning Event- June 5
708,6,5,11,CST,Morning Event- June 5
709,6,11,17,EST,Morning Event- June 5
710,3,6,9,CST,Morning Event- June 5
711,11,16,27,CST,Morning Event- June 5
712,7,11,18,CST,Morning Event- June 5
713,5,5,10,EST,Morning Event- June 5
714,5,5,10,CST,Morning Event- June 5
715,5,11,16,CST,Morning Event- June 5
716,8,5,13,CST,Morning Event- June 5
718,6,11,17,EST,Morning Event- June 5
719,2,18,20,EST,Morning Event- June 5
720,4,11,15,EST,Morning Event- June 5
721,5,11,16,EST,Morning Event- June 5
722,2,11,13,EST,Morning Event- June 5
723,3,6,9,CST,Morning Event- June 5
724,2,11,13,EST,Morning Event- June 5
725,6,16,22,EST,Morning Event- June 5
726,7,5,12,CST,Morning Event- June 5
727,4,5,9,EST,Morning Event- June 5
728,6,5,11,EST,Morning Event- June 5
729,6,11,17,EST,Morning Event- June 5
730,6,5,11,CST,Morning Event- June 5
731,2,5,7,CST,Morning Event- June 5
733,3,5,8,EST,Morning Event- June 5
734,11,11,22,CST,Morning Event- June 5
735,7,11,18,CST,Morning Event- June 5
736,6,6,12,CST,Morning Event- June 5
737,4,11,15,CST,Morning Event- June 5
738,10,5,15,CST,Morning Event- June 5
739,4,11,15,EST,Morning Event- June 5
740,4,5,9,CST,Morning Event- June 5
741,4,11,15,EST,Morning Event- June 5
742,3,16,19,EST,Morning Event- June 5
743,4,11,15,CST,Morning Event- June 5
744,6,11,17,CST,Morning Event- June 5
745,3,5,8,EST,Morning Event- June 5
746,6,11,17,CST,Morning Event- June 5
748,2,6,8,CST,Morning Event- June 5
749,5,5,10,CST,Morning Event- June 5
750,5,5,10,CST,Morning Event- June 5
751,6,5,11,CST,Morning Event- June 5
752,5,11,16,CST,Morning Event- June 5
753,3,11,14,CST,Morning Event- June 5
754,5,11,16,EST,Morning Event- June 5
755,5,16,21,CST,Morning Event- June 5
756,6,5,11,EST,Morning Event- June 5
757,8,11,19,CST,Morning Event- June 5
758,6,5,11,EST,Morning Event- June 5
759,6,5,11,EST,Morning Event- June 5
760,5,5,10,CST,Morning Event- June 5
761,8,5,13,CST,Morning Event- June 5
762,5,5,10,CST,Morning Event- June 5
764,5,5,10,CST,Morning Event- June 5
765,4,11,15,CST,Morning Event- June 5
766,11,16,27,CST,Morning Event- June 5
767,12,11,23,EST,Morning Event- June 5
768,5,11,16,CST,Morning Event- June 5
769,4,6,10,EST,Morning Event- June 5
770,8,11,19,CST,Morning Event- June 5
771,2,11,13,EST,Morning Event- June 5
772,5,6,11,CST,Morning Event- June 5
773,6,6,12,CST,Morning Event- June 5
774,11,11,22,CST,Morning Event- June 5
775,6,11,17,CST,Morning Event- June 5
776,11,11,22,CST,Morning Event- June 5
777,4,11,15,CST,Morning Event- June 5
778,6,6,12,EST,Morning Event- June 5
779,2,11,13,EST,Morning Event- June 5
780,4,11,15,EST,Morning Event- June 5
781,8,11,19,CST,Morning Event- June 5
782,8,11,19,CST,Morning Event- June 5
783,2,5,7,CST,Morning Event- June 5
784,6,5,11,CST,Morning Event- June 5
785,10,5,15,CST,Morning Event- June 5
786,4,11,15,CST,Morning Event- June 5
787,5,5,10,EST,Morning Event- June 5
788,5,5,10,CST,Morning Event- June 5
789,3,11,14,CST,Morning Event- June 5
790,6,5,11,CST,Morning Event- June 5
791,9,11,20,CST,Morning Event- June 5
792,5,5,10,CST,Morning Event- June 5
793,6,6,12,CST,Morning Event- June 5
794,14,11,25,CST,Morning Event- June 5
795,5,5,10,EST,Morning Event- June 5
796,3,11,14,CST,Morning Event- June 5
797,5,11,16,CST,Morning Event- June 5
798,4,5,9,CST,Morning Event- June 5
799,8,11,19,CST,Morning Event- June 5
800,6,11,17,EST,Morning Event- June 5
801,7,5,12,CST,Morning Event- June 5
802,7,11,18,CST,Morning Event- June 5
803,10,5,15,CST,Morning Event- June 5
804,6,6,12,CST,Morning Event- June 5
805,2,11,13,CST,Morning Event- June 5
807,5,11,16,CST,Morning Event- June 5
808,7,11,18,CST,Morning Event- June 5
809,7,11,18,CST,Morning Event- June 5
810,10,16,26,CST,Morning Event- June 5
811,7,5,12,EST,Morning Event- June 5
812,11,11,22,CST,Morning Event- June 5
813,10,11,21,CST,Morning Event- June 5
814,16,11,27,EST,Morning Event- June 5
815,8,11,19,CST,Morning Event- June 5
816,4,6,10,CST,Morning Event- June 5
817,4,17,21,EST,Morning Event- June 5
818,5,11,16,CST,Morning Event- June 5
819,2,11,13,EST,Morning Event- June 5
820,6,5,11,CST,Morning Event- June 5
822,9,11,20,CST,Morning Event- June 5
823,8,11,19,CST,Morning Event- June 5
825,6,5,11,EST,Morning Event- June 5
827,10,11,21,CST,Morning Event- June 5
828,6,16,22,EST,Morning Event- June 5
830,6,5,11,CST,Morning Event- June 5
833,6,5,11,CST,Morning Event- June 5
834,5,5,10,CST,Morning Event- June 5
836,2,16,18,EST,Morning Event- June 5
837,3,5,8,CST,Morning Event- June 5
838,3,11,14,CST,Morning Event- June 5
839,5,5,10,CST,Morning Event- June 5
841,5,5,10,CST,Morning Event- June 5
843,4,5,9,EST,Morning Event- June 5
844,4,11,15,CST,Morning Event- June 5
845,5,5,10,CST,Morning Event- June 5
846,6,5,11,CST,Morning Event- June 5
847,6,5,11,CST,Morning Event- June 5
848,5,5,10,CST,Morning Event- June 5
849,5,11,16,CST,Morning Event- June 5
852,6,11,17,CST,Morning Event- June 5
853,2,12,14,CST,Morning Event- June 5
854,2,5,7,EST,Morning Event- June 5
855,4,5,9,EST,Morning Event- June 5
856,2,11,13,EST,Morning Event- June 5
857,4,6,10,EST,Morning Event- June 5
858,3,5,8,EST,Morning Event- June 5
859,5,11,16,EST,Morning Event- June 5
860,5,11,16,EST,Morning Event- June 5
861,2,11,13,CST,Morning Event- June 5
862,12,18,30,EST,Morning Event- June 5
863,3,5,8,CST,Morning Event- June 5
864,8,11,19,EST,Morning Event- June 5
865,4,16,20,CST,Morning Event- June 5
866,2,11,13,CST,Morning Event- June 5
870,2,11,13,EST,Morning Event- June 5
871,5,5,10,CST,Morning Event- June 5
872,3,11,14,CST,Morning Event- June 5
874,8,5,13,CST,Morning Event- June 5
875,6,5,11,CST,Morning Event- June 5
876,5,5,10,CST,Morning Event- June 5
877,6,11,17,EST,Morning Event- June 5
878,4,11,15,EST,Morning Event- June 5
879,6,11,17,CST,Morning Event- June 5
880,6,11,17,CST,Morning Event- June 5
881,4,11,15,EST,Morning Event- June 5
882,8,6,14,CST,Morning Event- June 5
884,5,11,16,EST,Morning Event- June 5
885,6,5,11,CST,Morning Event- June 5
886,5,11,16,CST,Morning Event- June 5
887,6,5,11,CST,Morning Event- June 5
888,5,5,10,CST,Morning Event- June 5
889,2,5,7,EST,Morning Event- June 5
890,6,18,24,EST,Morning Event- June 5
891,6,11,17,CST,Morning Event- June 5
892,6,11,17,CST,Morning Event- June 5
893,5,5,10,CST,Morning Event- June 5
894,5,16,21,CST,Morning Event- June 5
895,4,5,9,CST,Morning Event- June 5
896,4,11,15,CST,Morning Event- June 5
897,6,5,11,CST,Morning Event- June 5
898,15,11,26,CST,Morning Event- June 5
899,6,11,17,EST,Morning Event- June 5
900,5,5,10,CST,Morning Event- June 5
901,6,11,17,CST,Morning Event- June 5
902,11,11,22,EST,Morning Event- June 5
903,5,5,10,CST,Morning Event- June 5
904,3,11,14,CST,Morning Event- June 5
907,5,6,11,EST,Morning Event- June 5
908,5,18,23,EST,Morning Event- June 5
909,2,5,7,CST,Morning Event- June 5
910,5,5,10,CST,Morning Event- June 5
911,3,5,8,CST,Morning Event- June 5
912,6,5,11,CST,Morning Event- June 5
913,5,11,16,CST,Morning Event- June 5
914,7,5,12,CST,Morning Event- June 5
915,2,11,13,CST,Morning Event- June 5
916,6,11,17,CST,Morning Event- June 5
917,4,5,9,CST,Morning Event- June 5
918,11,11,22,CST,Morning Event- June 5
919,2,16,18,CST,Morning Event- June 5
922,4,11,15,EST,Morning Event- June 5
923,3,11,14,EST,Morning Event- June 5
925,2,5,7,EST,Morning Event- June 5
927,9,11,20,CST,Morning Event- June 5
928,3,18,21,EST,Morning Event- June 5
929,3,11,14,EST,Morning Event- June 5
930,6,5,11,CST,Morning Event- June 5
931,2,11,13,EST,Morning Event- June 5
932,6,11,17,EST,Morning Event- June 5
933,4,5,9,CST,Morning Event- June 5
934,6,6,12,CST,Morning Event- June 5
935,6,11,17,CST,Morning Event- June 5
936,12,17,29,CST,Morning Event- June 5
937,3,11,14,EST,Morning Event- June 5
938,6,5,11,CST,Morning Event- June 5
939,2,11,13,CST,Morning Event- June 5
940,6,11,17,CST,Morning Event- June 5
941,6,11,17,EST,Morning Event- June 5
942,2,16,18,EST,Morning Event- June 5
943,6,11,17,EST,Morning Event- June 5
944,3,17,20,CST,Morning Event- June 5
945,6,11,17,CST,Morning Event- June 5
947,3,11,14,CST,Morning Event- June 5
948,3,11,14,EST,Morning Event- June 5
950,5,5,10,CST,Morning Event- June 5
951,5,5,10,CST,Morning Event- June 5
952,8,5,13,EST,Morning Event- June 5
954,4,5,9,CST,Morning Event- June 5
955,5,11,16,EST,Morning Event- June 5
956,4,6,10,EST,Morning Event- June 5
957,6,5,11,CST,Morning Event- June 5
958,3,11,14,CST,Morning Event- June 5
959,6,5,11,EST,Morning Event- June 5
960,2,11,13,EST,Morning Event- June 5
961,4,5,9,CST,Morning Event- June 5
963,5,11,16,CST,Morning Event- June 5
965,6,11,17,CST,Morning Event- June 5
967,3,11,14,EST,Morning Event- June 5
968,5,11,16,EST,Morning Event- June 5
969,6,11,17,CST,Morning Event- June 5
970,6,11,17,CST,Morning Event- June 5
971,6,5,11,CST,Morning Event- June 5
972,2,11,13,CST,Morning Event- June 5
973,2,11,13,EST,Morning Event- June 5
974,3,11,14,EST,Morning Event- June 5
975,15,11,26,CST,Morning Event- June 5
976,5,5,10,CST,Morning Event- June 5
977,6,5,11,EST,Morning Event- June 5
978,8,5,13,CST,Morning Event- June 5
979,2,5,7,CST,Morning Event- June 5
981,11,11,22,CST,Morning Event- June 5
982,6,5,11,CST,Morning Event- June 5
985,6,5,11,CST,Morning Event- June 5
987,6,5,11,EST,Morning Event- June 5
988,2,11,13,EST,Morning Event- June 5
989,6,11,17,CST,Morning Event- June 5
990,2,18,20,CST,Morning Event- June 5
991,6,5,11,CST,Morning Event- June 5
992,5,6,11,CST,Morning Event- June 5
993,6,5,11,CST,Morning Event- June 5
994,4,11,15,EST,Morning Event- June 5
995,6,11,17,EST,Morning Event- June 5
996,5,5,10,EST,Morning Event- June 5
999,6,11,17,CST,Morning Event- June 5
1000,9,18,27,CST,Morning Event- June 5
1002,2,5,7,EST,Morning Event- June 5
1003,4,6,10,CST,Morning Event- June 5
1004,5,11,16,EST,Morning Event- June 5
1005,5,11,16,CST,Morning Event- June 5
1006,8,5,13,EST,Morning Event- June 5
1007,6,5,11,CST,Morning Event- June 5
1009,2,11,13,CST,Morning Event- June 5
1010,10,11,21,EST,Morning Event- June 5
1011,4,11,15,EST,Morning Event- June 5
1012,4,11,15,CST,Morning Event- June 5
1013,3,5,8,EST,Morning Event- June 5
1014,6,11,17,CST,Morning Event- June 5
1016,3,11,14,CST,Morning Event- June 5
1017,5,5,10,EST,Morning Event- June 5
1018,8,5,13,EST,Morning Event- June 5
1020,3,6,9,CST,Morning Event- June 5
1021,5,11,16,CST,Morning Event- June 5
1022,9,11,20,CST,Morning Event- June 5
1023,6,11,17,EST,Morning Event- June 5
1024,9,5,14,EST,Morning Event- June 5
1025,9,11,20,CST,Morning Event- June 5
1026,3,11,14,EST,Morning Event- June 5
1027,4,11,15,EST,Morning Event- June 5
1028,3,11,14,CST,Morning Event- June 5
1029,6,5,11,EST,Morning Event- June 5
1030,6,11,17,EST,Morning Event- June 5
1032,2,11,13,CST,Morning Event- June 5
1033,5,11,16,EST,Morning Event- June 5
1034,6,11,17,EST,Morning Event- June 5
1035,2,11,13,EST,Morning Event- June 5
1036,4,11,15,EST,Morning Event- June 5
1037,15,11,26,EST,Morning Event- June 5
1038,5,5,10,CST,Morning Event- June 5
1039,8,11,19,EST,Morning Event- June 5
1040,3,11,14,CST,Morning Event- June 5
1041,8,18,26,CST,Morning Event- June 5
1042,2,11,13,CST,Morning Event- June 5
1043,10,5,15,CST,Morning Event- June 5
1044,2,11,13,CST,Morning Event- June 5
1046,10,5,15,CST,Morning Event- June 5
1047,6,6,12,EST,Morning Event- June 5
1048,7,11,18,EST,Morning Event- June 5
1051,7,5,12,CST,Morning Event- June 5
1052,4,5,9,CST,Morning Event- June 5
1053,5,11,16,EST,Morning Event- June 5
1054,2,5,7,CST,Morning Event- June 5
1055,5,11,16,CST,Morning Event- June 5
1056,6,6,12,CST,Morning Event- June 5
1057,2,5,7,CST,Morning Event- June 5
1059,8,5,13,CST,Morning Event- June 5
1060,4,16,20,EST,Morning Event- June 5
1061,3,5,8,EST,Morning Event- June 5
1062,4,11,15,CST,Morning Event- June 5
1063,5,5,10,CST,Morning Event- June 5
1064,6,11,17,EST,Morning Event- June 5
1065,5,5,10,CST,Morning Event- June 5
1066,6,11,17,CST,Morning Event- June 5
1067,5,5,10,CST,Morning Event- June 5
1068,6,6,12,EST,Morning Event- June 5
1069,3,5,8,CST,Morning Event- June 5
1070,10,11,21,EST,Morning Event- June 5
1071,5,11,16,CST,Morning Event- June 5
1072,7,11,18,EST,Morning Event- June 5
1073,3,5,8,CST,Morning Event- June 5
1074,6,5,11,CST,Morning Event- June 5
1075,6,16,22,CST,Morning Event- June 5
1076,5,5,10,EST,Morning Event- June 5
1077,2,5,7,EST,Morning Event- June 5
1079,6,11,17,EST,Morning Event- June 5
1080,2,16,18,EST,Morning Event- June 5
1081,5,11,16,EST,Morning Event- June 5
1082,4,11,15,EST,Morning Event- June 5
1083,2,11,13,EST,Morning Event- June 5
1084,5,11,16,EST,Morning Event- June 5
1085,6,11,17,EST,Morning Event- June 5
1086,3,17,20,EST,Morning Event- June 5
1087,2,11,13,EST,Morning Event- June 5
1088,2,5,7,CST,Morning Event- June 5
1089,5,11,16,CST,Morning Event- June 5
1090,5,6,11,EST,Morning Event- June 5
1091,9,11,20,CST,Morning Event- June 5
1093,6,5,11,CST,Morning Event- June 5
1094,5,5,10,CST,Morning Event- June 5
1096,6,11,17,EST,Morning Event- June 5
1097,6,11,17,EST,Morning Event- June 5
1098,6,6,12,CST,Morning Event- June 5
1099,4,11,15,CST,Morning Event- June 5
1100,5,5,10,CST,Morning Event- June 5
1101,6,6,12,CST,Morning Event- June 5
1102,6,5,11,CST,Morning Event- June 5
1103,2,11,13,CST,Morning Event- June 5
1104,5,11,16,EST,Morning Event- June 5
1105,4,6,10,CST,Morning Event- June 5
1106,5,5,10,CST,Morning Event- June 5
1107,2,5,7,CST,Morning Event- June 5
1108,5,5,10,CST,Morning Event- June 5
1109,3,5,8,CST,Morning Event- June 5
1110,3,5,8,CST,Morning Event- June 5
1111,6,11,17,EST,Morning Event- June 5
1112,6,5,11,EST,Morning Event- June 5
1113,3,17,20,EST,Morning Event- June 5
1114,5,5,10,CST,Morning Event- June 5
1115,6,5,11,CST,Morning Event- June 5
1116,8,11,19,CST,Morning Event- June 5
1117,6,11,17,CST,Morning Event- June 5
1118,5,11,16,CST,Morning Event- June 5
1119,6,5,11,EST,Morning Event- June 5
1120,2,11,13,CST,Morning Event- June 5
1121,7,11,18,EST,Morning Event- June 5
1122,8,11,19,EST,Morning Event- June 5
1123,2,16,18,EST,Morning Event- June 5
1124,6,5,11,CST,Morning Event- June 5
1125,2,16,18,CST,Morning Event- June 5
1126,5,6,11,CST,Morning Event- June 5
1128,2,5,7,CST,Morning Event- June 5
1129,3,11,14,CST,Morning Event- June 5
1130,3,5,8,EST,Morning Event- June 5
1131,6,5,11,EST,Morning Event- June 5
1132,11,16,27,EST,Morning Event- June 5
1133,6,11,17,EST,Morning Event- June 5
1134,2,11,13,CST,Morning Event- June 5
1135,5,5,10,EST,Morning Event- June 5
1136,6,5,11,CST,Morning Event- June 5
1137,5,11,16,CST,Morning Event- June 5
1138,2,11,13,CST,Morning Event- June 5
1139,11,17,28,EST,Morning Event- June 5
1140,6,11,17,EST,Morning Event- June 5
1141,6,11,17,EST,Morning Event- June 5
1142,6,5,11,EST,Morning Event- June 5
1143,5,5,10,EST,Morning Event- June 5
1144,6,6,12,EST,Morning Event- June 5
1146,2,11,13,EST,Morning Event- June 5
1147,3,5,8,CST,Morning Event- June 5
1148,6,11,17,CST,Morning Event- June 5
1150,5,11,16,CST,Morning Event- June 5
1151,3,11,14,CST,Morning Event- June 5
1152,10,6,16,CST,Morning Event- June 5
1153,6,5,11,EST,Morning Event- June 5
1154,5,6,11,CST,Morning Event- June 5
1155,10,11,21,EST,Morning Event- June 5
1156,2,16,18,EST,Morning Event- June 5
1157,2,5,7,EST,Morning Event- June 5
1158,2,5,7,CST,Morning Event- June 5
1159,6,5,11,EST,Morning Event- June 5
1160,6,16,22,EST,Morning Event- June 5
1161,5,11,16,CST,Morning Event- June 5
1162,9,11,20,EST,Morning Event- June 5
1163,2,5,7,CST,Morning Event- June 5
1164,6,6,12,EST,Morning Event- June 5
1165,4,11,15,EST,Morning Event- June 5
1166,4,5,9,EST,Morning Event- June 5
1167,2,11,13,CST,Morning Event- June 5
1168,8,5,13,CST,Morning Event- June 5
1169,4,5,9,CST,Morning Event- June 5
1170,3,6,9,EST,Morning Event- June 5
1171,5,6,11,EST,Morning Event- June 5
1172,4,11,15,EST,Morning Event- June 5
1173,4,11,15,EST,Morning Event- June 5
1174,5,5,10,CST,Morning Event- June 5
1176,2,5,7,CST,Morning Event- June 5
1177,3,11,14,CST,Morning Event- June 5
1178,3,11,14,CST,Morning Event- June 5
1179,4,11,15,EST,Morning Event- June 5
1180,2,11,13,EST,Morning Event- June 5
1181,2,6,8,EST,Morning Event- June 5
1182,2,11,13,EST,Morning Event- June 5
1183,6,11,17,EST,Morning Event- June 5
1184,4,5,9,EST,Morning Event- June 5
1185,3,11,14,CST,Morning Event- June 5
1186,8,11,19,CST,Morning Event- June 5
1187,4,5,9,CST,Morning Event- June 5
1188,4,6,10,CST,Morning Event- June 5
1189,5,5,10,EST,Morning Event- June 5
1190,4,11,15,EST,Morning Event- June 5
1191,3,11,14,EST,Morning Event- June 5
1192,6,6,12,CST,Morning Event- June 5
1193,6,5,11,CST,Morning Event- June 5
1194,2,11,13,EST,Morning Event- June 5
1195,9,11,20,CST,Morning Event- June 5
1196,2,5,7,CST,Morning Event- June 5
1197,6,5,11,EST,Morning Event- June 5
1198,6,11,17,CST,Morning Event- June 5
1201,2,11,13,CST,Morning Event- June 5
1202,5,11,16,CST,Morning Event- June 5
1203,2,18,20,EST,Morning Event- June 5
1204,6,11,17,CST,Morning Event- June 5
1205,8,11,19,EST,Morning Event- June 5
1206,6,6,12,CST,Morning Event- June 5
1207,6,11,17,CST,Morning Event- June 5
1209,3,11,14,EST,Morning Event- June 5
1210,6,11,17,EST,Morning Event- June 5
1211,6,5,11,CST,Morning Event- June 5
1212,3,11,14,CST,Morning Event- June 5
1213,4,11,15,EST,Morning Event- June 5
1214,2,5,7,CST,Morning Event- June 5
1215,2,16,18,EST,Morning Event- June 5
1216,4,11,15,CST,Morning Event- June 5
1217,7,11,18,EST,Morning Event- June 5
1219,5,6,11,EST,Morning Event- June 5
1220,6,11,17,EST,Morning Event- June 5
1221,2,11,13,CST,Morning Event- June 5
1222,5,11,16,CST,Morning Event- June 5
1223,4,6,10,EST,Morning Event- June 5
1224,6,11,17,CST,Morning Event- June 5
1225,2,11,13,EST,Morning Event- June 5
1226,6,5,11,CST,Morning Event- June 5
1227,6,11,17,EST,Morning Event- June 5
1228,4,11,15,CST,Morning Event- June 5
1229,4,5,9,CST,Morning Event- June 5
1232,4,11,15,CST,Morning Event- June 5
1233,2,11,13,EST,Morning Event- June 5
1234,6,6,12,EST,Morning Event- June 5
1235,4,5,9,CST,Morning Event- June 5
1236,6,6,12,EST,Morning Event- June 5
1237,2,11,13,EST,Morning Event- June 5
1238,6,11,17,EST,Morning Event- June 5
1239,6,11,17,EST,Morning Event- June 5
1241,5,16,21,CST,Morning Event- June 5
1242,3,18,21,EST,Morning Event- June 5
1243,3,11,14,EST,Morning Event- June 5
1244,2,11,13,EST,Morning Event- June 5
1245,6,11,17,EST,Morning Event- June 5
1247,5,11,16,EST,Morning Event- June 5
1248,4,5,9,CST,Morning Event- June 5
1249,2,5,7,CST,Morning Event- June 5
1253,5,11,16,CST,Morning Event- June 5
1254,5,11,16,CST,Morning Event- June 5
1255,5,5,10,EST,Morning Event- June 5
1256,3,11,14,CST,Morning Event- June 5
1257,5,5,10,CST,Morning Event- June 5
1259,6,11,17,EST,Morning Event- June 5
1260,15,11,26,CST,Morning Event- June 5
1261,6,11,17,EST,Morning Event- June 5
1263,4,11,15,CST,Morning Event- June 5
1264,15,11,26,EST,Morning Event- June 5
1265,2,5,7,CST,Morning Event- June 5
1266,4,5,9,CST,Morning Event- June 5
1267,2,11,13,CST,Morning Event- June 5
1268,7,11,18,EST,Morning Event- June 5
1270,6,11,17,EST,Morning Event- June 5
1271,6,5,11,CST,Morning Event- June 5
1272,10,5,15,CST,Morning Event- June 5
1274,5,5,10,CST,Morning Event- June 5
1275,5,11,16,EST,Morning Event- June 5
1276,6,11,17,CST,Morning Event- June 5
1277,5,5,10,CST,Morning Event- June 5
1279,5,11,16,CST,Morning Event- June 5
1281,6,11,17,EST,Morning Event- June 5
1282,2,5,7,CST,Morning Event- June 5
1283,2,11,13,EST,Morning Event- June 5
1284,6,11,17,CST,Morning Event- June 5
1285,3,11,14,CST,Morning Event- June 5
1286,5,5,10,EST,Morning Event- June 5
1287,2,11,13,EST,Morning Event- June 5
1288,5,6,11,EST,Morning Event- June 5
1289,6,11,17,EST,Morning Event- June 5
1290,6,11,17,EST,Morning Event- June 5
1292,5,11,16,EST,Morning Event- June 5
1293,4,6,10,EST,Morning Event- June 5
1294,6,11,17,EST,Morning Event- June 5
1295,4,5,9,CST,Morning Event- June 5
1296,3,11,14,CST,Morning Event- June 5
1297,6,11,17,EST,Morning Event- June 5
1298,7,11,18,EST,Morning Event- June 5
1300,3,11,14,EST,Morning Event- June 5
1301,6,11,17,EST,Morning Event- June 5
1302,8,16,24,EST,Morning Event- June 5
1303,3,11,14,CST,Morning Event- June 5
1304,3,16,19,EST,Morning Event- June 5
1305,2,16,18,CST,Morning Event- June 5
1307,4,11,15,CST,Morning Event- June 5
1309,6,11,17,EST,Morning Event- June 5
1310,9,11,20,EST,Morning Event- June 5
1311,5,11,16,EST,Morning Event- June 5
1312,6,11,17,EST,Morning Event- June 5
1313,6,11,17,CST,Morning Event- June 5
1314,6,6,12,EST,Morning Event- June 5
1316,4,5,9,CST,Morning Event- June 5
1317,3,5,8,EST,Morning Event- June 5
1318,5,11,16,EST,Morning Event- June 5
1319,2,16,18,EST,Morning Event- June 5
1320,6,11,17,EST,Morning Event- June 5
1321,6,11,17,EST,Morning Event- June 5
1322,2,11,13,EST,Morning Event- June 5
1323,4,5,9,CST,Morning Event- June 5
1326,11,11,22,CST,Morning Event- June 5
1327,11,11,22,EST,Morning Event- June 5
1329,7,11,18,EST,Morning Event- June 5
1330,6,11,17,EST,Morning Event- June 5
1331,2,11,13,EST,Morning Event- June 5
1332,2,11,13,CST,Morning Event- June 5
1333,11,11,22,EST,Morning Event- June 5
1335,2,11,13,EST,Morning Event- June 5
1336,6,5,11,EST,Morning Event- June 5
1337,14,16,30,EST,Morning Event- June 5
1338,6,6,12,EST,Morning Event- June 5
1339,5,6,11,EST,Morning Event- June 5
1340,5,5,10,EST,Morning Event- June 5
1341,6,11,17,CST,Morning Event- June 5
1342,3,5,8,CST,Morning Event- June 5
1344,6,11,17,EST,Morning Event- June 5
1345,4,5,9,EST,Morning Event- June 5
1346,4,11,15,CST,Morning Event- June 5
1347,5,6,11,CST,Morning Event- June 5
1348,6,11,17,EST,Morning Event- June 5
1349,2,6,8,EST,Morning Event- June 5
1350,4,11,15,EST,Morning Event- June 5
1351,4,11,15,EST,Morning Event- June 5
1352,6,5,11,EST,Morning Event- June 5
1353,4,6,10,CST,Morning Event- June 5
1354,9,5,14,EST,Morning Event- June 5
1355,6,11,17,EST,Morning Event- June 5
1356,5,11,16,EST,Morning Event- June 5
1358,9,6,15,EST,Morning Event- June 5
1359,3,5,8,EST,Morning Event- June 5
1360,8,11,19,EST,Morning Event- June 5
1361,8,11,19,CST,Morning Event- June 5
1362,3,11,14,CST,Morning Event- June 5
1363,4,6,10,EST,Morning Event- June 5
1365,5,5,10,CST,Morning Event- June 5
1366,5,5,10,CST,Morning Event- June 5
1367,5,17,22,EST,Morning Event- June 5
1368,8,5,13,EST,Morning Event- June 5
1371,6,11,17,EST,Morning Event- June 5
1372,3,6,9,EST,Morning Event- June 5
1373,3,11,14,EST,Morning Event- June 5
1374,5,11,16,EST,Morning Event- June 5
1375,10,11,21,CST,Morning Event- June 5
1376,2,17,19,CST,Morning Event- June 5
1377,4,11,15,CST,Morning Event- June 5
1378,5,11,16,EST,Morning Event- June 5
1379,6,6,12,EST,Morning Event- June 5
1382,6,11,17,EST,Morning Event- June 5
1383,7,11,18,EST,Morning Event- June 5
1385,4,11,15,EST,Morning Event- June 5
1386,5,11,16,CST,Morning Event- June 5
1387,5,6,11,EST,Morning Event- June 5
1388,2,11,13,EST,Morning Event- June 5
1389,6,5,11,CST,Morning Event- June 5
1390,3,11,14,EST,Morning Event- June 5
1391,5,11,16,EST,Morning Event- June 5
1392,3,11,14,EST,Morning Event- June 5
1393,7,11,18,CST,Morning Event- June 5
1394,2,11,13,CST,Morning Event- June 5
1395,2,6,8,CST,Morning Event- June 5
1396,5,11,16,CST,Morning Event- June 5
1398,3,5,8,EST,Morning Event- June 5
1399,2,5,7,EST,Morning Event- June 5
1400,2,11,13,EST,Morning Event- June 5
1401,2,11,13,CST,Morning Event- June 5
1403,8,11,19,EST,Morning Event- June 5
1404,3,5,8,CST,Morning Event- June 5
1405,9,11,20,CST,Morning Event- June 5
1406,5,11,16,EST,Morning Event- June 5
1407,3,11,14,EST,Morning Event- June 5
1408,6,6,12,EST,Morning Event- June 5
1409,5,11,16,CST,Morning Event- June 5
1410,2,11,13,EST,Morning Event- June 5
1413,6,11,17,CST,Morning Event- June 5
1415,9,11,20,CST,Morning Event- June 5
1416,6,5,11,EST,Morning Event- June 5
1418,2,11,13,CST,Morning Event- June 5
1419,4,16,20,EST,Morning Event- June 5
1420,2,11,13,CST,Morning Event- June 5
1421,6,11,17,CST,Morning Event- June 5
1422,6,6,12,EST,Morning Event- June 5
1423,4,11,15,EST,Morning Event- June 5
1424,4,11,15,EST,Morning Event- June 5
1425,5,11,16,EST,Morning Event- June 5
1426,3,17,20,EST,Morning Event- June 5
1427,6,11,17,EST,Morning Event- June 5
1428,6,17,23,EST,Morning Event- June 5
1429,5,11,16,EST,Morning Event- June 5
1430,2,11,13,CST,Morning Event- June 5
1431,7,11,18,CST,Morning Event- June 5
1432,6,16,22,EST,Morning Event- June 5
1433,7,11,18,EST,Morning Event- June 5
1435,7,5,12,CST,Morning Event- June 5
1436,2,6,8,EST,Morning Event- June 5
1437,10,6,16,CST,Morning Event- June 5
1441,2,11,13,EST,Morning Event- June 5
1443,4,16,20,EST,Morning Event- June 5
1444,2,11,13,EST,Morning Event- June 5
1445,5,5,10,EST,Morning Event- June 5
1446,8,16,24,CST,Morning Event- June 5
1447,5,16,21,CST,Morning Event- June 5
1448,4,11,15,EST,Morning Event- June 5
1449,6,16,22,CST,Morning Event- June 5
1450,10,11,21,EST,Morning Event- June 5
1451,4,10,14,CST,Morning Event- June 5
1452,3,5,8,EST,Morning Event- June 5
1453,5,16,21,CST,Morning Event- June 5
1454,9,16,25,CST,Morning Event- June 5
1455,3,6,9,CST,Morning Event- June 5
1458,6,17,23,EST,Morning Event- June 5
1459,6,11,17,EST,Morning Event- June 5
1460,11,11,22,CST,Morning Event- June 5
1462,8,5,13,CST,Morning Event- June 5
1463,3,11,14,EST,Morning Event- June 5
1464,6,6,12,EST,Morning Event- June 5
1465,5,11,16,EST,Morning Event- June 5
1466,3,11,14,EST,Morning Event- June 5
1467,6,5,11,CST,Morning Event- June 5
1468,10,5,15,CST,Morning Event- June 5
1469,5,11,16,EST,Morning Event- June 5
1470,8,11,19,CST,Morning Event- June 5
1471,5,5,10,CST,Morning Event- June 5
1472,3,11,14,CST,Morning Event- June 5
1473,5,11,16,CST,Morning Event- June 5
1475,6,5,11,CST,Morning Event- June 5
1476,3,11,14,EST,Morning Event- June 5
1477,10,11,21,EST,Morning Event- June 5
1478,6,11,17,EST,Morning Event- June 5
1479,2,11,13,CST,Morning Event- June 5
1480,6,5,11,EST,Morning Event- June 5
1481,3,10,13,CST,Morning Event- June 5
1482,6,5,11,EST,Morning Event- June 5
1483,7,11,18,CST,Morning Event- June 5
1486,7,11,18,EST,Morning Event- June 5
1487,6,11,17,CST,Morning Event- June 5
1488,5,11,16,EST,Morning Event- June 5
1489,4,5,9,CST,Morning Event- June 5
1490,4,11,15,CST,Morning Event- June 5
1491,6,11,17,CST,Morning Event- June 5
1493,4,5,9,CST,Morning Event- June 5
1494,2,16,18,CST,Morning Event- June 5
1495,4,11,15,EST,Morning Event- June 5
1496,3,21,24,CST,Morning Event- June 5
1497,5,5,10,CST,Morning Event- June 5
1498,5,5,10,EST,Morning Event- June 5
1499,7,11,18,EST,Morning Event- June 5
1500,16,11,27,CST,Morning Event- June 5
1501,3,5,8,EST,Morning Event- June 5
1502,4,6,10,EST,Morning Event- June 5
1503,6,11,17,EST,Morning Event- June 5
1504,2,11,13,EST,Morning Event- June 5
1505,15,17,32,EST,Morning Event- June 5
1506,3,5,8,CST,Morning Event- June 5
1507,5,11,16,CST,Morning Event- June 5
1509,4,5,9,CST,Morning Event- June 5
1510,6,18,24,EST,Morning Event- June 5
1511,4,6,10,EST,Morning Event- June 5
1513,6,5,11,EST,Morning Event- June 5
1514,5,16,21,CST,Morning Event- June 5
1515,2,5,7,CST,Morning Event- June 5
1516,3,11,14,CST,Morning Event- June 5
1517,2,5,7,EST,Morning Event- June 5
1518,3,6,9,EST,Morning Event- June 5
1519,6,11,17,EST,Morning Event- June 5
1520,11,11,22,CST,Morning Event- June 5
1521,5,5,10,EST,Morning Event- June 5
1522,7,11,18,EST,Morning Event- June 5
1523,3,11,14,EST,Morning Event- June 5
1524,5,6,11,EST,Morning Event- June 5
1525,4,11,15,EST,Morning Event- June 5
1526,6,6,12,CST,Morning Event- June 5
1527,10,16,26,EST,Morning Event- June 5
1528,2,11,13,CST,Morning Event- June 5
1529,2,17,19,EST,Morning Event- June 5
1530,2,5,7,CST,Morning Event- June 5
1531,3,6,9,CST,Morning Event- June 5
1534,6,11,17,CST,Morning Event- June 5
1535,6,16,22,CST,Morning Event- June 5
1536,6,11,17,EST,Morning Event- June 5
1537,4,6,10,EST,Morning Event- June 5
1538,11,16,27,CST,Morning Event- June 5
1539,2,16,18,EST,Morning Event- June 5
1540,3,11,14,EST,Morning Event- June 5
1541,6,11,17,EST,Morning Event- June 5
1542,12,16,28,EST,Morning Event- June 5
1544,2,11,13,EST,Morning Event- June 5
1545,5,11,16,CST,Morning Event- June 5
1546,6,5,11,CST,Morning Event- June 5
1547,4,11,15,EST,Morning Event- June 5
1548,5,5,10,CST,Morning Event- June 5
1551,5,5,10,CST,Morning Event- June 5
1552,6,11,17,EST,Morning Event- June 5
1553,2,11,13,CST,Morning Event- June 5
1556,4,11,15,CST,Morning Event- June 5
1557,5,5,10,EST,Morning Event- June 5
1558,3,6,9,EST,Morning Event- June 5
1561,5,5,10,CST,Morning Event- June 5
1562,3,5,8,CST,Morning Event- June 5
1564,2,16,18,EST,Morning Event- June 5
1565,15,23,38,CST,Morning Event- June 5
1566,4,11,15,EST,Morning Event- June 5
1568,5,16,21,EST,Morning Event- June 5
1569,4,11,15,EST,Morning Event- June 5
1570,3,11,14,EST,Morning Event- June 5
1571,5,6,11,CST,Morning Event- June 5
1576,4,11,15,CST,Morning Event- June 5
1577,5,11,16,CST,Morning Event- June 5
1578,3,11,14,EST,Morning Event- June 5
1579,5,5,10,EST,Morning Event- June 5
1580,4,6,10,EST,Morning Event- June 5
1581,5,11,16,CST,Morning Event- June 5
1585,10,11,21,CST,Morning Event- June 5
1586,4,11,15,EST,Morning Event- June 5
1589,2,5,7,EST,Morning Event- June 5
1590,2,11,13,EST,Morning Event- June 5
1591,5,11,16,EST,Morning Event- June 5
1592,2,5,7,EST,Morning Event- June 5
1593,2,11,13,EST,Morning Event- June 5
1594,6,17,23,EST,Morning Event- June 5
1595,2,11,13,EST,Morning Event- June 5
1596,4,6,10,CST,Morning Event- June 5
1597,3,11,14,CST,Morning Event- June 5
1599,2,5,7,CST,Morning Event- June 5
1601,6,11,17,EST,Morning Event- June 5
1602,3,11,14,CST,Morning Event- June 5
1603,4,5,9,EST,Morning Event- June 5
1605,6,11,17,CST,Morning Event- June 5
1606,4,11,15,EST,Morning Event- June 5
1607,6,17,23,EST,Morning Event- June 5
1609,10,11,21,CST,Morning Event- June 5
1610,6,6,12,EST,Morning Event- June 5
1611,6,11,17,EST,Morning Event- June 5
1613,5,6,11,EST,Morning Event- June 5
1614,2,5,7,EST,Morning Event- June 5
1618,3,11,14,CST,Morning Event- June 5
1619,3,11,14,EST,Morning Event- June 5
1620,8,5,13,CST,Morning Event- June 5
1621,5,5,10,CST,Morning Event- June 5
1622,6,11,17,EST,Morning Event- June 5
1623,2,17,19,EST,Morning Event- June 5
1625,6,5,11,CST,Morning Event- June 5
1626,3,11,14,CST,Morning Event- June 5
1627,6,11,17,CST,Morning Event- June 5
1628,5,11,16,EST,Morning Event- June 5
1629,6,5,11,EST,Morning Event- June 5
1631,5,11,16,EST,Morning Event- June 5
1632,8,11,19,CST,Morning Event- June 5
1633,3,11,14,CST,Morning Event- June 5
1634,15,11,26,CST,Morning Event- June 5
1635,2,5,7,CST,Morning Event- June 5
1636,6,17,23,CST,Morning Event- June 5
1637,5,11,16,CST,Morning Event- June 5
1638,3,5,8,CST,Morning Event- June 5
1639,4,5,9,EST,Morning Event- June 5
1640,6,11,17,EST,Morning Event- June 5
1641,8,5,13,EST,Morning Event- June 5
1642,2,11,13,EST,Morning Event- June 5
1643,3,11,14,CST,Morning Event- June 5
1644,2,16,18,EST,Morning Event- June 5
1647,3,11,14,EST,Morning Event- June 5
1649,11,11,22,CST,Morning Event- June 5
1650,3,5,8,CST,Morning Event- June 5
1652,6,5,11,EST,Morning Event- June 5
1653,4,5,9,EST,Morning Event- June 5
1654,8,17,25,CST,Morning Event- June 5
1655,10,11,21,EST,Morning Event- June 5
1656,8,11,19,EST,Morning Event- June 5
1657,6,6,12,CST,Morning Event- June 5
1658,6,5,11,EST,Morning Event- June 5
1661,2,11,13,EST,Morning Event- June 5
1662,6,11,17,EST,Morning Event- June 5
1663,10,17,27,EST,Morning Event- June 5
1664,5,11,16,EST,Morning Event- June 5
1665,2,11,13,EST,Morning Event- June 5
1666,3,6,9,EST,Morning Event- June 5
1667,10,11,21,EST,Morning Event- June 5
1668,3,11,14,CST,Morning Event- June 5
1669,3,16,19,CST,Morning Event- June 5
1670,5,11,16,EST,Morning Event- June 5
1671,2,11,13,CST,Morning Event- June 5
1672,6,6,12,CST,Morning Event- June 5
1673,3,11,14,EST,Morning Event- June 5
1674,2,11,13,EST,Morning Event- June 5
1675,9,5,14,EST,Morning Event- June 5
1676,4,6,10,CST,Morning Event- June 5
1677,6,11,17,EST,Morning Event- June 5
1678,2,5,7,CST,Morning Event- June 5
1679,5,16,21,CST,Morning Event- June 5
1680,3,11,14,EST,Morning Event- June 5
1681,2,6,8,CST,Morning Event- June 5
1682,5,11,16,EST,Morning Event- June 5
1683,2,10,12,CST,Morning Event- June 5
1684,5,5,10,EST,Morning Event- June 5
1685,11,11,22,CST,Morning Event- June 5
1687,5,11,16,EST,Morning Event- June 5
1688,5,5,10,EST,Morning Event- June 5
1690,3,11,14,CST,Morning Event- June 5
1691,3,11,14,CST,Morning Event- June 5
1694,2,11,13,EST,Morning Event- June 5
1695,7,5,12,CST,Morning Event- June 5
1696,7,6,13,CST,Morning Event- June 5
1698,4,16,20,EST,Morning Event- June 5
1701,5,5,10,EST,Morning Event- June 5
1702,2,11,13,EST,Morning Event- June 5
1703,6,11,17,EST,Morning Event- June 5
1705,6,11,17,EST,Morning Event- June 5
1707,2,11,13,EST,Morning Event- June 5
1709,7,11,18,EST,Morning Event- June 5
1710,6,5,11,CST,Morning Event- June 5
1711,5,5,10,CST,Morning Event- June 5
1712,5,11,16,EST,Morning Event- June 5
1713,10,11,21,CST,Morning Event- June 5
1714,2,11,13,EST,Morning Event- June 5
1715,4,5,9,EST,Morning Event- June 5
1716,3,6,9,EST,Morning Event- June 5
1717,2,5,7,EST,Morning Event- June 5
1718,6,11,17,EST,Morning Event- June 5
1719,7,16,23,EST,Morning Event- June 5
1720,3,11,14,EST,Morning Event- June 5
1721,3,5,8,CST,Morning Event- June 5
1722,10,11,21,CST,Morning Event- June 5
1723,4,11,15,CST,Morning Event- June 5
1724,6,5,11,EST,Morning Event- June 5
1726,5,11,16,EST,Morning Event- June 5
1727,6,5,11,CST,Morning Event- June 5
1728,2,16,18,EST,Morning Event- June 5
1729,2,5,7,EST,Morning Event- June 5
1730,5,5,10,EST,Morning Event- June 5
1731,3,11,14,EST,Morning Event- June 5
1732,10,5,15,CST,Morning Event- June 5
1733,6,11,17,EST,Morning Event- June 5
1734,2,11,13,CST,Morning Event- June 5
1735,3,5,8,CST,Morning Event- June 5
1736,4,11,15,EST,Morning Event- June 5
1737,2,6,8,CST,Morning Event- June 5
1738,5,11,16,CST,Morning Event- June 5
1739,4,16,20,EST,Morning Event- June 5
1740,2,11,13,CST,Morning Event- June 5
1741,6,11,17,EST,Morning Event- June 5
1742,4,11,15,EST,Morning Event- June 5
1743,8,5,13,EST,Morning Event- June 5
1744,4,11,15,EST,Morning Event- June 5
1745,6,11,17,EST,Morning Event- June 5
1748,6,11,17,EST,Morning Event- June 5
1749,5,11,16,EST,Morning Event- June 5
1750,5,11,16,EST,Morning Event- June 5
1751,3,5,8,EST,Morning Event- June 5
1752,5,16,21,EST,Morning Event- June 5
1753,3,11,14,EST,Morning Event- June 5
1754,2,11,13,EST,Morning Event- June 5
1757,3,11,14,CST,Morning Event- June 5
1758,6,11,17,EST,Morning Event- June 5
1759,6,11,17,EST,Morning Event- June 5
1761,4,5,9,CST,Morning Event- June 5
1762,2,17,19,EST,Morning Event- June 5
1763,8,11,19,EST,Morning Event- June 5
1764,6,11,17,CST,Morning Event- June 5
1765,6,11,17,EST,Morning Event- June 5
1766,4,5,9,EST,Morning Event- June 5
1767,3,11,14,EST,Morning Event- June 5
1769,15,16,31,EST,Morning Event- June 5
1770,3,11,14,EST,Morning Event- June 5
1771,10,11,21,EST,Morning Event- June 5
1773,3,6,9,EST,Morning Event- June 5
1774,3,11,14,EST,Morning Event- June 5
1776,3,11,14,CST,Morning Event- June 5
1777,4,11,15,EST,Morning Event- June 5
1779,5,11,16,CST,Morning Event- June 5
1780,3,11,14,EST,Morning Event- June 5
1781,2,16,18,EST,Morning Event- June 5
1782,5,17,22,EST,Morning Event- June 5
1783,6,11,17,CST,Morning Event- June 5
1785,5,17,22,EST,Morning Event- June 5
1786,5,5,10,CST,Morning Event- June 5
1787,9,11,20,CST,Morning Event- June 5
1788,3,18,21,EST,Morning Event- June 5
1790,3,11,14,EST,Morning Event- June 5
1791,4,11,15,EST,Morning Event- June 5
1792,8,11,19,EST,Morning Event- June 5
1794,6,17,23,EST,Morning Event- June 5
1795,4,6,10,EST,Morning Event- June 5
1796,2,18,20,EST,Morning Event- June 5
1797,11,11,22,EST,Morning Event- June 5
1798,9,11,20,EST,Morning Event- June 5
1799,6,11,17,CST,Morning Event- June 5
1800,4,11,15,CST,Morning Event- June 5
1801,6,11,17,CST,Morning Event- June 5
1802,3,11,14,CST,Morning Event- June 5
1803,5,11,16,CST,Morning Event- June 5
1804,5,11,16,EST,Morning Event- June 5
1806,3,11,14,EST,Morning Event- June 5
1807,3,5,8,EST,Morning Event- June 5
1809,4,11,15,EST,Morning Event- June 5
1810,6,18,24,EST,Morning Event- June 5
1811,6,5,11,EST,Morning Event- June 5
1812,6,11,17,EST,Morning Event- June 5
1813,5,11,16,EST,Morning Event- June 5
1814,3,11,14,CST,Morning Event- June 5
1816,3,5,8,EST,Morning Event- June 5
1819,2,11,13,CST,Morning Event- June 5
1820,4,11,15,EST,Morning Event- June 5
1821,6,5,11,EST,Morning Event- June 5
1822,50,125,175,AST,Morning Event- June 5
1823,6,11,17,EST,Morning Event- June 5
1825,2,11,13,EST,Morning Event- June 5
1828,5,16,21,CST,Morning Event- June 5
1829,2,5,7,EST,Morning Event- June 5
1830,5,11,16,EST,Morning Event- June 5
1831,3,11,14,EST,Morning Event- June 5
1833,2,11,13,EST,Morning Event- June 5
1835,5,18,23,EST,Morning Event- June 5
1836,4,16,20,EST,Morning Event- June 5
1837,6,11,17,CST,Morning Event- June 5
1839,3,11,14,EST,Morning Event- June 5
1841,2,11,13,EST,Morning Event- June 5
1842,4,11,15,EST,Morning Event- June 5
1844,4,11,15,EST,Morning Event- June 5
1845,2,6,8,EST,Morning Event- June 5
1847,5,11,16,EST,Morning Event- June 5
1848,2,5,7,CST,Morning Event- June 5
1849,6,5,11,EST,Morning Event- June 5
1850,3,17,20,EST,Morning Event- June 5
1851,2,11,13,EST,Morning Event- June 5
1852,5,11,16,EST,Morning Event- June 5
1854,80,225,305,AST,Morning Event- June 5
1855,4,5,9,CST,Morning Event- June 5
1856,9,23,32,EST,Morning Event- June 5
1857,4,11,15,EST,Morning Event- June 5
1858,6,5,11,CST,Morning Event- June 5
1860,6,11,17,EST,Morning Event- June 5
1861,4,5,9,CST,Morning Event- June 5
1863,4,6,10,EST,Morning Event- June 5
1864,5,6,11,CST,Morning Event- June 5
1865,6,5,11,CST,Morning Event- June 5
1866,4,11,15,EST,Morning Event- June 5
1867,3,6,9,EST,Morning Event- June 5
1868,6,18,24,EST,Morning Event- June 5
1869,5,6,11,EST,Morning Event- June 5
1871,9,11,20,EST,Morning Event- June 5
1873,5,11,16,EST,Morning Event- June 5
1874,5,5,10,EST,Morning Event- June 5
1875,2,11,13,EST,Morning Event- June 5
1883,3,11,14,EST,Morning Event- June 5
1884,3,17,20,EST,Morning Event- June 5
1885,5,11,16,EST,Morning Event- June 5
1886,4,11,15,EST,Morning Event- June 5
1887,3,11,14,EST,Morning Event- June 5
1890,2,11,13,EST,Morning Event- June 5
1891,2,16,18,EST,Morning Event- June 5
1892,5,11,16,CST,Morning Event- June 5
1893,3,5,8,EST,Morning Event- June 5
1894,5,11,16,EST,Morning Event- June 5
1895,5,5,10,EST,Morning Event- June 5
1897,5,5,10,CST,Morning Event- June 5
1898,4,5,9,CST,Morning Event- June 5
1904,5,11,16,EST,Morning Event- June 5
1906,5,11,16,EST,Morning Event- June 5
1907,2,11,13,EST,Morning Event- June 5
1908,4,11,15,CST,Morning Event- June 5
1909,4,11,15,EST,Morning Event- June 5
1911,3,11,14,EST,Morning Event- June 5
1913,5,11,16,EST,Morning Event- June 5
1916,5,6,11,EST,Morning Event- June 5
1918,5,11,16,EST,Morning Event- June 5
1919,6,5,11,EST,Morning Event- June 5
1921,3,5,8,EST,Morning Event- June 5
1923,2,11,13,EST,Morning Event- June 5
1924,13,16,29,EST,Morning Event- June 5
1926,5,11,16,EST,Morning Event- June 5
1927,3,5,8,EST,Morning Event- June 5
1928,4,11,15,EST,Morning Event- June 5
1929,5,11,16,CST,Morning Event- June 5
1930,3,11,14,EST,Morning Event- June 5
1931,10,11,21,CST,Morning Event- June 5
1932,14,17,31,EST,Morning Event- June 5
1933,4,11,15,CST,Morning Event- June 5
1934,7,11,18,EST,Morning Event- June 5
1935,6,11,17,EST,Morning Event- June 5
1936,12,11,23,EST,Morning Event- June 5
1937,8,11,19,EST,Morning Event- June 5
1938,6,11,17,CST,Morning Event- June 5
1939,5,16,21,EST,Morning Event- June 5
1940,2,11,13,EST,Morning Event- June 5
1942,2,11,13,EST,Morning Event- June 5
1943,2,16,18,CST,Morning Event- June 5
1945,6,11,17,EST,Morning Event- June 5
1946,15,11,26,EST,Morning Event- June 5
1948,2,11,13,EST,Morning Event- June 5
1949,6,16,22,EST,Morning Event- June 5
1950,4,5,9,EST,Morning Event- June 5
1952,3,5,8,CST,Morning Event- June 5
1953,5,5,10,EST,Morning Event- June 5
1954,4,11,15,EST,Morning Event- June 5
1955,4,11,15,CST,Morning Event- June 5
1957,5,5,10,EST,Morning Event- June 5
1958,5,16,21,CST,Morning Event- June 5
1959,5,16,21,EST,Morning Event- June 5
1960,5,11,16,EST,Morning Event- June 5
1961,4,11,15,EST,Morning Event- June 5
1962,5,16,21,EST,Morning Event- June 5
1964,5,11,16,EST,Morning Event- June 5
1965,6,11,17,CST,Morning Event- June 5
1966,5,11,16,EST,Morning Event- June 5
1967,3,16,19,EST,Morning Event- June 5
1968,6,11,17,EST,Morning Event- June 5
1969,3,11,14,EST,Morning Event- June 5
1970,3,6,9,EST,Morning Event- June 5
1971,3,11,14,CST,Morning Event- June 5
1973,6,16,22,EST,Morning Event- June 5
1974,8,5,13,EST,Morning Event- June 5
1975,6,11,17,EST,Morning Event- June 5
1976,2,16,18,EST,Morning Event- June 5
1977,5,11,16,EST,Morning Event- June 5
1978,2,11,13,EST,Morning Event- June 5
1980,2,11,13,EST,Morning Event- June 5
1981,2,11,13,EST,Morning Event- June 5
1982,3,16,19,CST,Morning Event- June 5
1984,2,11,13,EST,Morning Event- June 5
1985,3,11,14,EST,Morning Event- June 5
1986,5,11,16,EST,Morning Event- June 5
1987,3,16,19,EST,Morning Event- June 5
1990,2,5,7,EST,Morning Event- June 5
1991,2,17,19,EST,Morning Event- June 5
1993,3,11,14,EST,Morning Event- June 5
1994,3,16,19,EST,Morning Event- June 5
1996,5,11,16,EST,Morning Event- June 5
1997,2,11,13,EST,Morning Event- June 5
1998,4,11,15,CST,Morning Event- June 5
1999,5,6,11,CST,Morning Event- June 5
2000,9,11,20,EST,Morning Event- June 5
2003,5,11,16,EST,Morning Event- June 5
2004,6,11,17,CST,Morning Event- June 5
2005,5,11,16,EST,Morning Event- June 5
2008,6,6,12,EST,Morning Event- June 5
2009,3,5,8,EST,Morning Event- June 5
2010,6,11,17,EST,Morning Event- June 5
2012,3,11,14,EST,Morning Event- June 5
2013,6,17,23,EST,Morning Event- June 5
2014,8,11,19,EST,Morning Event- June 5
2015,4,11,15,EST,Morning Event- June 5
2019,2,11,13,EST,Morning Event- June 5
2020,6,5,11,CST,Morning Event- June 5
2021,6,11,17,EST,Morning Event- June 5
2022,3,11,14,EST,Morning Event- June 5
2023,2,11,13,EST,Morning Event- June 5
2024,5,11,16,EST,Morning Event- June 5
2026,80,220,300,AST,Morning Event- June 5
2027,6,18,24,EST,Morning Event- June 5
2033,5,5,10,CST,Morning Event- June 5
2035,3,11,14,EST,Morning Event- June 5
2036,4,16,20,EST,Morning Event- June 5
2038,4,11,15,EST,Morning Event- June 5
2040,2,11,13,EST,Morning Event- June 5
2041,4,5,9,EST,Morning Event- June 5
2043,10,5,15,EST,Morning Event- June 5
2045,3,6,9,EST,Morning Event- June 5
2046,5,17,22,EST,Morning Event- June 5
2047,6,11,17,EST,Morning Event- June 5
2049,4,17,21,EST,Morning Event- June 5
2055,4,16,20,EST,Morning Event- June 5
2056,4,16,20,EST,Morning Event- June 5
2057,5,5,10,EST,Morning Event- June 5
2058,5,5,10,EST,Morning Event- June 5
2059,3,11,14,EST,Morning Event- June 5
2061,2,11,13,EST,Morning Event- June 5
2062,3,5,8,EST,Morning Event- June 5
2063,5,11,16,EST,Morning Event- June 5
2064,4,11,15,EST,Morning Event- June 5
2065,4,11,15,EST,Morning Event- June 5
2066,2,6,8,CST,Morning Event- June 5
2067,85,245,330,AST,Morning Event- June 5
2068,2,11,13,EST,Morning Event- June 5
2072,50,125,175,AST,Morning Event- June 5
2073,6,11,17,EST,Morning Event- June 5
2078,8,16,24,EST,Morning Event- June 5
2079,5,11,16,EST,Morning Event- June 5
2080,6,11,17,EST,Morning Event- June 5
2081,2,11,13,EST,Morning Event- June 5
2083,2,11,13,EST,Morning Event- June 5
2085,60,165,225,AST,Morning Event- June 5
2086,5,5,10,CST,Morning Event- June 5
2087,4,11,15,CST,Morning Event- June 5
2088,5,11,16,EST,Morning Event- June 5
2089,5,17,22,EST,Morning Event- June 5
2090,6,6,12,EST,Morning Event- June 5
2091,4,23,27,EST,Morning Event- June 5
2092,4,5,9,EST,Morning Event- June 5
2093,5,11,16,EST,Morning Event- June 5
2095,5,11,16,EST,Morning Event- June 5
2096,6,5,11,EST,Morning Event- June 5
2097,6,6,12,EST,Morning Event- June 5
2098,2,6,8,EST,Morning Event- June 5
2100,10,11,21,EST,Morning Event- June 5
2102,10,11,21,EST,Morning Event- June 5
2103,5,11,16,EST,Morning Event- June 5
2104,3,17,20,EST,Morning Event- June 5
2105,5,11,16,CST,Morning Event- June 5
2107,3,11,14,EST,Morning Event- June 5
2108,2,6,8,EST,Morning Event- June 5
2109,5,5,10,EST,Morning Event- June 5
2111,2,6,8,CST,Morning Event- June 5
2114,11,11,22,CST,Morning Event- June 5
2115,3,11,14,EST,Morning Event- June 5
2116,2,16,18,EST,Morning Event- June 5
2118,6,11,17,EST,Morning Event- June 5
2120,3,16,19,EST,Morning Event- June 5
2122,3,6,9,EST,Morning Event- June 5
2123,10,11,21,CST,Morning Event- June 5
2124,4,16,20,EST,Morning Event- June 5
2127,2,16,18,CST,Morning Event- June 5
2128,3,5,8,EST,Morning Event- June 5
2129,2,11,13,EST,Morning Event- June 5
2130,4,6,10,EST,Morning Event- June 5
2131,6,5,11,CST,Morning Event- June 5
2132,2,5,7,CST,Morning Event- June 5
2133,4,11,15,CST,Morning Event- June 5
2134,5,6,11,EST,Morning Event- June 5
2135,5,11,16,EST,Morning Event- June 5
2136,6,11,17,EST,Morning Event- June 5
2137,5,6,11,EST,Morning Event- June 5
2138,5,11,16,EST,Morning Event- June 5
2139,4,16,20,EST,Morning Event- June 5
2140,12,16,28,EST,Morning Event- June 5
2141,6,11,17,EST,Morning Event- June 5
2142,6,17,23,EST,Morning Event- June 5
2143,10,6,16,EST,Morning Event- June 5
2144,6,11,17,EST,Morning Event- June 5
2145,5,16,21,EST,Morning Event- June 5
2146,5,11,16,EST,Morning Event- June 5
2149,6,11,17,EST,Morning Event- June 5
2151,5,11,16,EST,Morning Event- June 5
2152,3,11,14,EST,Morning Event- June 5
2153,6,11,17,EST,Morning Event- June 5
2154,2,11,13,EST,Morning Event- June 5
2155,4,11,15,EST,Morning Event- June 5
2156,4,5,9,EST,Morning Event- June 5
2157,6,11,17,EST,Morning Event- June 5
2158,4,11,15,EST,Morning Event- June 5
2159,12,17,29,EST,Morning Event- June 5
2160,6,5,11,EST,Morning Event- June 5
2163,5,11,16,EST,Morning Event- June 5
2164,6,11,17,EST,Morning Event- June 5
2166,4,11,15,EST,Morning Event- June 5
2167,2,6,8,EST,Morning Event- June 5
2169,6,17,23,EST,Morning Event- June 5
2170,3,11,14,EST,Morning Event- June 5
2174,2,16,18,EST,Morning Event- June 5
2175,8,5,13,CST,Morning Event- June 5
2176,4,11,15,EST,Morning Event- June 5
2178,7,5,12,EST,Morning Event- June 5
2180,6,11,17,EST,Morning Event- June 5
2183,2,11,13,EST,Morning Event- June 5
2184,6,11,17,EST,Morning Event- June 5
2185,3,11,14,EST,Morning Event- June 5
2191,6,11,17,EST,Morning Event- June 5
2192,8,11,19,EST,Morning Event- June 5
2193,6,11,17,EST,Morning Event- June 5
2194,5,11,16,EST,Morning Event- June 5
2195,4,11,15,EST,Morning Event- June 5
2197,4,11,15,EST,Morning Event- June 5
2198,5,6,11,CST,Morning Event- June 5
2199,5,11,16,EST,Morning Event- June 5
2200,2,11,13,EST,Morning Event- June 5
2202,3,16,19,EST,Morning Event- June 5
2204,2,11,13,CST,Morning Event- June 5
2205,6,11,17,EST,Morning Event- June 5
2208,9,16,25,EST,Morning Event- June 5
2209,8,11,19,EST,Morning Event- June 5
2210,4,11,15,EST,Morning Event- June 5
2211,4,11,15,EST,Morning Event- June 5
2213,5,11,16,CST,Morning Event- June 5
2214,5,5,10,EST,Morning Event- June 5
2215,5,5,10,CST,Morning Event- June 5
2221,2,18,20,CST,Morning Event- June 5
2222,3,11,14,EST,Morning Event- June 5
2224,4,11,15,EST,Morning Event- June 5
2225,2,11,13,EST,Morning Event- June 5
2227,6,6,12,EST,Morning Event- June 5
2228,6,11,17,EST,Morning Event- June 5
2230,6,11,17,EST,Morning Event- June 5
2231,3,11,14,CST,Morning Event- June 5
2232,4,11,15,EST,Morning Event- June 5
2233,2,16,18,EST,Morning Event- June 5
2234,5,11,16,EST,Morning Event- June 5
2236,3,5,8,EST,Morning Event- June 5
2237,5,11,16,EST,Morning Event- June 5
2238,4,11,15,EST,Morning Event- June 5
2239,6,17,23,CST,Morning Event- June 5
2240,65,180,245,AST,Morning Event- June 5
2244,6,11,17,EST,Morning Event- June 5
2247,6,5,11,EST,Morning Event- June 5
2248,3,11,14,EST,Morning Event- June 5
2250,2,11,13,EST,Morning Event- June 5
2252,6,11,17,EST,Morning Event- June 5
2254,2,5,7,EST,Morning Event- June 5
2255,5,11,16,EST,Morning Event- June 5
2256,5,5,10,EST,Morning Event- June 5
2257,2,11,13,CST,Morning Event- June 5
2258,5,6,11,EST,Morning Event- June 5
2261,3,11,14,EST,Morning Event- June 5
2262,11,16,27,EST,Morning Event- June 5
2263,3,6,9,EST,Morning Event- June 5
2264,2,11,13,EST,Morning Event- June 5
2265,5,11,16,EST,Morning Event- June 5
2266,3,11,14,EST,Morning Event- June 5
2267,5,6,11,EST,Morning Event- June 5
2271,9,11,20,CST,Morning Event- June 5
2272,6,5,11,EST,Morning Event- June 5
2273,2,11,13,EST,Morning Event- June 5
2274,3,11,14,CST,Morning Event- June 5
2275,5,6,11,EST,Morning Event- June 5
2276,5,11,16,CST,Morning Event- June 5
2278,6,11,17,EST,Morning Event- June 5
2279,2,11,13,EST,Morning Event- June 5
2281,2,11,13,EST,Morning Event- June 5
2282,2,11,13,EST,Morning Event- June 5
2283,3,11,14,EST,Morning Event- June 5
2284,2,11,13,EST,Morning Event- June 5
2285,2,11,13,EST,Morning Event- June 5
2286,6,11,17,EST,Morning Event- June 5
2287,6,11,17,EST,Morning Event- June 5
2289,8,11,19,EST,Morning Event- June 5
2294,5,11,16,EST,Morning Event- June 5
2295,3,5,8,EST,Morning Event- June 5
2299,2,11,13,EST,Morning Event- June 5
2300,5,11,16,EST,Morning Event- June 5
2302,50,125,175,AST,Morning Event- June 5
2306,2,6,8,CST,Morning Event- June 5
2309,4,11,15,EST,Morning Event- June 5
2310,3,11,14,EST,Morning Event- June 5
2311,8,11,19,EST,Morning Event- June 5
2312,6,11,17,EST,Morning Event- June 5
2313,2,6,8,EST,Morning Event- June 5
2316,2,11,13,EST,Morning Event- June 5
2318,4,17,21,EST,Morning Event- June 5
2322,6,5,11,CST,Morning Event- June 5
2323,3,11,14,EST,Morning Event- June 5
2326,5,11,16,EST,Morning Event- June 5
2329,5,5,10,EST,Morning Event- June 5
2330,2,18,20,EST,Morning Event- June 5
2331,6,16,22,EST,Morning Event- June 5
2332,2,11,13,EST,Morning Event- June 5
2334,6,11,17,EST,Morning Event- June 5
2335,6,6,12,CST,Morning Event- June 5
2336,2,11,13,EST,Morning Event- June 5
2337,5,11,16,EST,Morning Event- June 5
2338,2,16,18,EST,Morning Event- June 5
2339,2,11,13,EST,Morning Event- June 5
2340,3,11,14,EST,Morning Event- June 5
2341,5,11,16,EST,Morning Event- June 5
2346,75,205,280,AST,Morning Event- June 5
2348,6,5,11,EST,Morning Event- June 5
2350,5,11,16,EST,Morning Event- June 5
2351,6,11,17,EST,Morning Event- June 5
2352,6,11,17,CST,Morning Event- June 5
2354,2,11,13,EST,Morning Event- June 5
2355,4,11,15,EST,Morning Event- June 5
2357,6,16,22,EST,Morning Event- June 5
2358,5,11,16,EST,Morning Event- June 5
2359,4,16,20,EST,Morning Event- June 5
2361,4,11,15,EST,Morning Event- June 5
2362,2,5,7,EST,Morning Event- June 5
2365,2,11,13,EST,Morning Event- June 5
2366,5,16,21,EST,Morning Event- June 5
2367,8,11,19,CST,Morning Event- June 5
2368,6,11,17,EST,Morning Event- June 5
2369,6,11,17,EST,Morning Event- June 5
2370,4,6,10,EST,Morning Event- June 5
2371,6,11,17,EST,Morning Event- June 5
2373,4,11,15,EST,Morning Event- June 5
2386,5,16,21,EST,Morning Event- June 5
2387,2,11,13,EST,Morning Event- June 5
2388,2,5,7,EST,Morning Event- June 5
2398,5,6,11,EST,Morning Event- June 5
2399,6,16,22,EST,Morning Event- June 5
2400,7,16,23,EST,Morning Event- June 5
2404,5,11,16,CST,Morning Event- June 5
2405,6,16,22,EST,Morning Event- June 5
2412,2,6,8,EST,Morning Event- June 5
2417,6,11,17,EST,Morning Event- June 5
2419,3,11,14,EST,Morning Event- June 5
2420,5,11,16,EST,Morning Event- June 5
2421,6,11,17,CST,Morning Event- June 5
2423,95,255,350,AST,Morning Event- June 5
2424,6,5,11,EST,Morning Event- June 5
2426,3,11,14,EST,Morning Event- June 5
2427,5,5,10,CST,Morning Event- June 5
2428,9,11,20,CST,Morning Event- June 5
2429,6,11,17,EST,Morning Event- June 5
2432,6,11,17,CST,Morning Event- June 5
2434,3,16,19,CST,Morning Event- June 5
2435,5,11,16,EST,Morning Event- June 5
2436,6,11,17,EST,Morning Event- June 5
2437,5,11,16,EST,Morning Event- June 5
2438,3,11,14,EST,Morning Event- June 5
2439,6,11,17,CST,Morning Event- June 5
2440,7,11,18,EST,Morning Event- June 5
2441,5,6,11,EST,Morning Event- June 5
2443,6,11,17,CST,Morning Event- June 5
2444,3,11,14,EST,Morning Event- June 5
2445,2,11,13,EST,Morning Event- June 5
2446,2,11,13,EST,Morning Event- June 5
2447,5,5,10,EST,Morning Event- June 5
2448,4,11,15,CST,Morning Event- June 5
2449,95,255,350,AST,Morning Event- June 5
2452,3,5,8,CST,Morning Event- June 5
2459,2,11,13,EST,Morning Event- June 5
2460,5,11,16,EST,Morning Event- June 5
2463,2,5,7,CST,Morning Event- June 5
2471,4,5,9,EST,Morning Event- June 5
2472,4,11,15,EST,Morning Event- June 5
2474,2,5,7,EST,Morning Event- June 5
2475,6,11,17,EST,Morning Event- June 5
2480,7,11,18,EST,Morning Event- June 5
2481,4,11,15,EST,Morning Event- June 5
2484,4,5,9,EST,Morning Event- June 5
2490,3,11,14,CST,Morning Event- June 5
2491,6,11,17,CST,Morning Event- June 5
2493,3,5,8,EST,Morning Event- June 5
2496,6,11,17,EST,Morning Event- June 5
2497,2,11,13,EST,Morning Event- June 5
2501,85,235,320,AST,Morning Event- June 5
2502,6,11,17,EST,Morning Event- June 5
2503,6,11,17,EST,Morning Event- June 5
2504,3,11,14,EST,Morning Event- June 5
2505,4,5,9,CST,Morning Event- June 5
2506,3,11,14,EST,Morning Event- June 5
2509,5,5,10,CST,Morning Event- June 5
2510,6,5,11,CST,Morning Event- June 5
2513,5,5,10,EST,Morning Event- June 5
2514,6,5,11,EST,Morning Event- June 5
2518,3,11,14,EST,Morning Event- June 5
2519,3,11,14,EST,Morning Event- June 5
2520,5,5,10,EST,Morning Event- June 5
2522,14,16,30,EST,Morning Event- June 5
2528,6,11,17,EST,Morning Event- June 5
2529,2,11,13,EST,Morning Event- June 5
2530,8,11,19,EST,Morning Event- June 5
2531,5,16,21,EST,Morning Event- June 5
2532,2,11,13,CST,Morning Event- June 5
2533,2,11,13,CST,Morning Event- June 5
2534,6,11,17,CST,Morning Event- June 5
2535,6,11,17,EST,Morning Event- June 5
2540,6,11,17,EST,Morning Event- June 5
2541,5,11,16,EST,Morning Event- June 5
2542,5,5,10,EST,Morning Event- June 5
2543,5,11,16,EST,Morning Event- June 5
2544,5,11,16,CST,Morning Event- June 5
2545,7,11,18,CST,Morning Event- June 5
2547,6,11,17,EST,Morning Event- June 5
2548,9,5,14,EST,Morning Event- June 5
2551,2,11,13,EST,Morning Event- June 5
2555,3,6,9,EST,Morning Event- June 5
2558,3,5,8,EST,Morning Event- June 5
2559,5,11,16,EST,Morning Event- June 5
2560,6,11,17,EST,Morning Event- June 5
2561,2,11,13,EST,Morning Event- June 5
2563,3,5,8,EST,Morning Event- June 5
2564,6,5,11,EST,Morning Event- June 5
2565,6,6,12,EST,Morning Event- June 5
2566,3,11,14,EST,Morning Event- June 5
2567,3,11,14,EST,Morning Event- June 5
2572,5,11,16,EST,Morning Event- June 5
2574,5,11,16,EST,Morning Event- June 5
2575,6,11,17,CST,Morning Event- June 5
2576,6,11,17,EST,Morning Event- June 5
2577,5,6,11,EST,Morning Event- June 5
2580,5,6,11,EST,Morning Event- June 5
2581,5,17,22,EST,Morning Event- June 5
2582,4,5,9,EST,Morning Event- June 5
2583,5,11,16,EST,Morning Event- June 5
2584,6,5,11,EST,Morning Event- June 5
2585,5,16,21,EST,Morning Event- June 5
2586,6,11,17,EST,Morning Event- June 5
2587,5,17,22,CST,Morning Event- June 5
2588,3,6,9,EST,Morning Event- June 5
2591,3,11,14,EST,Morning Event- June 5
2597,8,11,19,EST,Morning Event- June 5
2599,2,16,18,CST,Morning Event- June 5
2600,6,5,11,CST,Morning Event- June 5
2603,2,5,7,EST,Morning Event- June 5
2604,3,11,14,EST,Morning Event- June 5
2605,9,11,20,EST,Morning Event- June 5
2610,6,11,17,EST,Morning Event- June 5
2611,6,11,17,EST,Morning Event- June 5
2613,5,5,10,EST,Morning Event- June 5
2614,4,11,15,EST,Morning Event- June 5
2615,3,11,14,EST,Morning Event- June 5
2616,3,11,14,CST,Morning Event- June 5
2618,4,11,15,EST,Morning Event- June 5
2619,4,16,20,EST,Morning Event- June 5
2620,5,11,16,EST,Morning Event- June 5
2626,7,11,18,EST,Morning Event- June 5
2627,4,6,10,EST,Morning Event- June 5
2628,6,16,22,EST,Morning Event- June 5
2629,5,11,16,EST,Morning Event- June 5
2630,7,11,18,EST,Morning Event- June 5
2631,3,11,14,EST,Morning Event- June 5
2633,3,6,9,EST,Morning Event- June 5
2634,6,5,11,EST,Morning Event- June 5
2637,3,11,14,EST,Morning Event- June 5
2638,6,11,17,EST,Morning Event- June 5
2639,6,11,17,EST,Morning Event- June 5
2640,2,11,13,EST,Morning Event- June 5
2641,5,16,21,EST,Morning Event- June 5
2642,4,11,15,CST,Morning Event- June 5
2643,5,5,10,CST,Morning Event- June 5
2644,3,11,14,EST,Morning Event- June 5
2645,2,5,7,EST,Morning Event- June 5
2646,6,5,11,EST,Morning Event- June 5
2647,6,5,11,EST,Morning Event- June 5
2649,5,5,10,CST,Morning Event- June 5
2650,4,11,15,EST,Morning Event- June 5
2651,3,6,9,EST,Morning Event- June 5
2654,3,5,8,CST,Morning Event- June 5
2658,2,11,13,CST,Morning Event- June 5
2659,6,6,12,EST,Morning Event- June 5
2660,3,6,9,EST,Morning Event- June 5
2662,3,5,8,EST,Morning Event- June 5
2663,6,11,17,EST,Morning Event- June 5
2664,5,6,11,EST,Morning Event- June 5
2665,2,11,13,CST,Morning Event- June 5
2667,3,11,14,CST,Morning Event- June 5
2668,6,11,17,CST,Morning Event- June 5
2674,2,5,7,EST,Morning Event- June 5
2678,5,16,21,EST,Morning Event- June 5
2679,4,11,15,EST,Morning Event- June 5
2681,6,11,17,EST,Morning Event- June 5
2682,2,11,13,EST,Morning Event- June 5
2683,5,6,11,EST,Morning Event- June 5
2684,5,5,10,EST,Morning Event- June 5
2687,4,11,15,EST,Morning Event- June 5
2688,6,16,22,CST,Morning Event- June 5
2690,3,11,14,CST,Morning Event- June 5
2691,4,11,15,EST,Morning Event- June 5
2692,4,11,15,EST,Morning Event- June 5
2693,3,11,14,EST,Morning Event- June 5
2694,2,5,7,CST,Morning Event- June 5
2695,5,11,16,EST,Morning Event- June 5
2696,8,5,13,EST,Morning Event- June 5
2700,3,11,14,EST,Morning Event- June 5
2702,2,11,13,CST,Morning Event- June 5
2703,2,5,7,EST,Morning Event- June 5
2704,2,6,8,EST,Morning Event- June 5
2705,5,5,10,EST,Morning Event- June 5
2706,4,11,15,CST,Morning Event- June 5
2712,4,11,15,EST,Morning Event- June 5
2713,5,5,10,CST,Morning Event- June 5
2714,6,11,17,CST,Morning Event- June 5
2715,2,11,13,CST,Morning Event- June 5
2716,5,11,16,CST,Morning Event- June 5
2717,6,5,11,CST,Morning Event- June 5
2718,10,6,16,CST,Morning Event- June 5
2719,5,11,16,EST,Morning Event- June 5
2720,2,5,7,CST,Morning Event- June 5
2721,55,155,210,AST,Morning Event- June 5
2723,6,5,11,CST,Morning Event- June 5
2724,2,11,13,CST,Morning Event- June 5
2725,2,11,13,EST,Morning Event- June 5
2726,5,16,21,EST,Morning Event- June 5
2727,6,11,17,EST,Morning Event- June 5
2728,4,11,15,CST,Morning Event- June 5
2730,6,5,11,EST,Morning Event- June 5
2732,5,11,16,EST,Morning Event- June 5
2733,2,5,7,EST,Morning Event- June 5
2734,3,11,14,CST,Morning Event- June 5
2739,7,5,12,CST,Morning Event- June 5
2740,2,11,13,EST,Morning Event- June 5
2747,3,11,14,EST,Morning Event- June 5
2748,4,5,9,CST,Morning Event- June 5
2749,6,11,17,EST,Morning Event- June 5
2753,8,5,13,EST,Morning Event- June 5
2754,2,5,7,EST,Morning Event- June 5
2755,6,16,22,CST,Morning Event- June 5
2756,5,11,16,EST,Morning Event- June 5
2757,5,11,16,CST,Morning Event- June 5
2758,2,6,8,EST,Morning Event- June 5
2760,9,5,14,CST,Morning Event- June 5
2761,4,11,15,EST,Morning Event- June 5
2762,6,6,12,EST,Morning Event- June 5
2763,3,16,19,CST,Morning Event- June 5
2764,5,11,16,CST,Morning Event- June 5
2765,6,5,11,CST,Morning Event- June 5
2769,5,6,11,CST,Morning Event- June 5
2771,6,6,12,EST,Morning Event- June 5
2772,6,5,11,EST,Morning Event- June 5
2774,4,5,9,EST,Morning Event- June 5
2783,4,5,9,EST,Morning Event- June 5
2784,5,5,10,CST,Morning Event- June 5
2785,3,6,9,EST,Morning Event- June 5
2786,2,11,13,EST,Morning Event- June 5
2787,3,5,8,EST,Morning Event- June 5
2788,3,11,14,EST,Morning Event- June 5
2789,2,6,8,EST,Morning Event- June 5
2790,5,11,16,EST,Morning Event- June 5
2791,4,11,15,EST,Morning Event- June 5
2792,5,5,10,EST,Morning Event- June 5
2793,6,11,17,EST,Morning Event- June 5
2795,6,5,11,EST,Morning Event- June 5
2796,5,11,16,EST,Morning Event- June 5
2797,3,11,14,EST,Morning Event- June 5
2799,3,6,9,EST,Morning Event- June 5
2803,5,11,16,CST,Morning Event- June 5
2804,3,11,14,CST,Morning Event- June 5
2805,3,5,8,EST,Morning Event- June 5
2806,2,11,13,EST,Morning Event- June 5
2807,5,5,10,EST,Morning Event- June 5
2808,5,11,16,EST,Morning Event- June 5
2809,3,11,14,EST,Morning Event- June 5
2810,3,5,8,EST,Morning Event- June 5
2811,3,6,9,EST,Morning Event- June 5
2812,5,11,16,CST,Morning Event- June 5
2813,6,11,17,CST,Morning Event- June 5
2814,3,17,20,EST,Morning Event- June 5
2815,4,11,15,CST,Morning Event- June 5
2816,5,6,11,CST,Morning Event- June 5
2817,6,5,11,CST,Morning Event- June 5
2818,2,11,13,CST,Morning Event- June 5
2819,2,11,13,EST,Morning Event- June 5
2820,9,5,14,CST,Morning Event- June 5
2821,2,11,13,EST,Morning Event- June 5
2822,5,6,11,CST,Morning Event- June 5
2823,4,11,15,EST,Morning Event- June 5
2825,6,11,17,EST,Morning Event- June 5
2827,3,11,14,CST,Morning Event- June 5
2828,3,11,14,CST,Morning Event- June 5
2830,2,5,7,EST,Morning Event- June 5
2832,6,5,11,EST,Morning Event- June 5
2833,6,5,11,EST,Morning Event- June 5
2834,3,11,14,CST,Morning Event- June 5
2836,2,5,7,EST,Morning Event- June 5
2841,6,11,17,EST,Morning Event- June 5
2843,2,6,8,EST,Morning Event- June 5
2844,3,11,14,EST,Morning Event- June 5
2845,6,5,11,EST,Morning Event- June 5
2846,3,5,8,CST,Morning Event- June 5
2847,3,11,14,CST,Morning Event- June 5
2849,4,5,9,EST,Morning Event- June 5
2850,6,5,11,EST,Morning Event- June 5
2852,6,6,12,EST,Morning Event- June 5
2853,5,5,10,EST,Morning Event- June 5
2854,6,11,17,EST,Morning Event- June 5
2855,3,11,14,CST,Morning Event- June 5
2856,6,5,11,CST,Morning Event- June 5
2857,6,11,17,CST,Morning Event- June 5
2859,6,11,17,EST,Morning Event- June 5
2860,2,11,13,EST,Morning Event- June 5
2864,2,11,13,CST,Morning Event- June 5
2866,5,11,16,EST,Morning Event- June 5
2867,2,6,8,EST,Morning Event- June 5
2869,3,11,14,EST,Morning Event- June 5
2871,3,6,9,EST,Morning Event- June 5
2872,6,11,17,EST,Morning Event- June 5
2873,4,6,10,EST,Morning Event- June 5
2874,2,11,13,EST,Morning Event- June 5
2881,2,16,18,EST,Morning Event- June 5
2882,2,5,7,CST,Morning Event- June 5
2883,5,5,10,CST,Morning Event- June 5
2885,2,6,8,EST,Morning Event- June 5
2888,4,11,15,EST,Morning Event- June 5
2889,5,11,16,CST,Morning Event- June 5
2890,4,11,15,EST,Morning Event- June 5
2891,15,18,33,CST,Morning Event- June 5
2893,8,5,13,CST,Morning Event- June 5
2894,8,6,14,EST,Morning Event- June 5
2897,4,11,15,EST,Morning Event- June 5
2898,2,11,13,EST,Morning Event- June 5
2899,2,6,8,EST,Morning Event- June 5
2900,2,6,8,EST,Morning Event- June 5
2901,3,11,14,EST,Morning Event- June 5
2902,3,11,14,EST,Morning Event- June 5
2903,2,6,8,EST,Morning Event- June 5
2904,2,5,7,EST,Morning Event- June 5
2905,3,11,14,EST,Morning Event- June 5
2906,3,11,14,EST,Morning Event- June 5
2908,3,5,8,EST,Morning Event- June 5
2909,5,5,10,EST,Morning Event- June 5
2910,5,11,16,EST,Morning Event- June 5
2911,4,11,15,EST,Morning Event- June 5
2912,4,11,15,EST,Morning Event- June 5
2913,6,5,11,CST,Morning Event- June 5
2914,3,11,14,EST,Morning Event- June 5
2915,2,11,13,EST,Morning Event- June 5
2916,3,11,14,EST,Morning Event- June 5
2917,6,11,17,EST,Morning Event- June 5
2918,2,5,7,CST,Morning Event- June 5
2920,3,11,14,EST,Morning Event- June 5
2926,2,5,7,CST,Morning Event- June 5
2928,4,11,15,EST,Morning Event- June 5
2929,4,11,15,EST,Morning Event- June 5
2931,6,6,12,EST,Morning Event- June 5
2932,3,11,14,EST,Morning Event- June 5
2933,6,11,17,EST,Morning Event- June 5
2934,8,5,13,CST,Morning Event- June 5
2935,9,5,14,CST,Morning Event- June 5
2937,10,11,21,CST,Morning Event- June 5
2938,6,5,11,CST,Morning Event- June 5
2939,6,5,11,CST,Morning Event- June 5
2941,2,5,7,EST,Morning Event- June 5
2945,4,6,10,EST,Morning Event- June 5
2946,6,11,17,EST,Morning Event- June 5
2953,6,6,12,EST,Morning Event- June 5
2954,5,11,16,EST,Morning Event- June 5
2955,2,5,7,CST,Morning Event- June 5
2956,3,11,14,CST,Morning Event- June 5
2957,9,11,20,CST,Morning Event- June 5
2958,4,16,20,CST,Morning Event- June 5
2959,4,11,15,EST,Morning Event- June 5
2962,4,6,10,EST,Morning Event- June 5
2963,2,11,13,EST,Morning Event- June 5
2964,6,11,17,EST,Morning Event- June 5
2965,6,11,17,EST,Morning Event- June 5
2966,3,11,14,EST,Morning Event- June 5
2967,4,16,20,EST,Morning Event- June 5
2968,6,5,11,EST,Morning Event- June 5
2973,5,5,10,CST,Morning Event- June 5
2978,2,11,13,CST,Morning Event- June 5
2980,5,11,16,CST,Morning Event- June 5
2986,3,11,14,CST,Morning Event- June 5
2987,2,11,13,EST,Morning Event- June 5
2988,6,11,17,EST,Morning Event- June 5
2990,6,11,17,CST,Morning Event- June 5
2991,6,11,17,CST,Morning Event- June 5
2992,6,11,17,EST,Morning Event- June 5
2993,2,6,8,CST,Morning Event- June 5
2994,15,11,26,CST,Morning Event- June 5
2996,5,5,10,CST,Morning Event- June 5
3004,2,11,13,CST,Morning Event- June 5
3014,6,6,12,CST,Morning Event- June 5
3017,5,11,16,CST,Morning Event- June 5
3035,5,11,16,EST,Morning Event- June 5
3044,2,5,7,CST,Morning Event- June 5
3055,2,6,8,CST,Morning Event- June 5
3056,3,11,14,CST,Morning Event- June 5
3057,5,6,11,CST,Morning Event- June 5
3058,5,11,16,CST,Morning Event- June 5
3059,6,5,11,CST,Morning Event- June 5
3060,5,5,10,CST,Morning Event- June 5
3061,2,5,7,CST,Morning Event- June 5
3067,5,6,11,EST,Morning Event- June 5
3075,2,11,13,CST,Morning Event- June 5
3077,3,6,9,EST,Morning Event- June 5
3078,4,6,10,EST,Morning Event- June 5
3088,2,5,7,CST,Morning Event- June 5
3102,5,11,16,CST,Morning Event- June 5
3103,6,5,11,CST,Morning Event- June 5
3106,5,11,16,CST,Morning Event- June 5
3107,5,5,10,CST,Morning Event- June 5
3112,5,11,16,CST,Morning Event- June 5
3114,2,16,18,EST,Morning Event- June 5
3118,2,5,7,EST,Morning Event- June 5
3119,6,6,12,CST,Morning Event- June 5
3137,6,5,11,CST,Morning Event- June 5
3150,2,11,13,CST,Morning Event- June 5
3151,4,5,9,CST,Morning Event- June 5
3159,2,17,19,EST,Morning Event- June 5
3163,2,11,13,EST,Morning Event- June 5
3167,2,5,7,CST,Morning Event- June 5
3169,2,11,13,CST,Morning Event- June 5
3170,5,11,16,CST,Morning Event- June 5
3182,2,5,7,EST,Morning Event- June 5
3188,4,5,9,EST,Morning Event- June 5
3191,6,5,11,EST,Morning Event- June 5
3192,6,11,17,EST,Morning Event- June 5
3197,2,5,7,EST,Morning Event- June 5
3200,6,11,17,EST,Morning Event- June 5
3201,6,5,11,EST,Morning Event- June 5
3205,5,5,10,EST,Morning Event- June 5
3206,6,11,17,EST,Morning Event- June 5
3207,5,11,16,EST,Morning Event- June 5
3209,4,11,15,CST,Morning Event- June 5
3210,6,11,17,CST,Morning Event- June 5
3212,6,11,17,EST,Morning Event- June 5
3213,5,11,16,CST,Morning Event- June 5
3214,5,6,11,EST,Morning Event- June 5
3215,5,11,16,EST,Morning Event- June 5
3216,2,6,8,EST,Morning Event- June 5
3219,4,11,15,EST,Morning Event- June 5
3221,6,5,11,EST,Morning Event- June 5
3222,4,11,15,EST,Morning Event- June 5
3223,4,11,15,EST,Morning Event- June 5
3224,5,11,16,CST,Morning Event- June 5
3225,4,6,10,CST,Morning Event- June 5
3226,6,16,22,CST,Morning Event- June 5
3228,3,6,9,EST,Morning Event- June 5
3229,4,5,9,CST,Morning Event- June 5
3230,5,11,16,CST,Morning Event- June 5
3231,4,5,9,CST,Morning Event- June 5
3233,8,11,19,CST,Morning Event- June 5
3234,5,6,11,EST,Morning Event- June 5
3235,2,11,13,EST,Morning Event- June 5
3236,3,11,14,EST,Morning Event- June 5
3237,4,11,15,CST,Morning Event- June 5
3243,3,11,14,EST,Morning Event- June 5
3245,7,5,12,CST,Morning Event- June 5
3247,6,11,17,CST,Morning Event- June 5
3250,4,5,9,EST,Morning Event- June 5
3251,6,11,17,EST,Morning Event- June 5
3252,2,5,7,EST,Morning Event- June 5
3253,6,5,11,EST,Morning Event- June 5
3255,5,6,11,CST,Morning Event- June 5
3262,7,11,18,EST,Morning Event- June 5
3265,6,11,17,EST,Morning Event- June 5
3266,3,5,8,EST,Morning Event- June 5
3267,6,11,17,CST,Morning Event- June 5
3268,8,6,14,CST,Morning Event- June 5
3269,8,5,13,EST,Morning Event- June 5
3270,9,11,20,EST,Morning Event- June 5
3271,6,11,17,CST,Morning Event- June 5
3273,4,6,10,CST,Morning Event- June 5
3274,4,5,9,CST,Morning Event- June 5
3278,4,11,15,CST,Morning Event- June 5
3279,3,11,14,CST,Morning Event- June 5
3280,3,6,9,EST,Morning Event- June 5
3281,6,11,17,EST,Morning Event- June 5
3282,2,11,13,EST,Morning Event- June 5
3283,4,11,15,CST,Morning Event- June 5
3284,2,5,7,CST,Morning Event- June 5
3285,6,5,11,CST,Morning Event- June 5
3286,3,6,9,CST,Morning Event- June 5
3288,6,5,11,CST,Morning Event- June 5
3289,4,11,15,EST,Morning Event- June 5
3291,6,6,12,EST,Morning Event- June 5
3292,6,16,22,EST,Morning Event- June 5
3293,5,6,11,EST,Morning Event- June 5
3294,5,11,16,EST,Morning Event- June 5
3295,5,6,11,CST,Morning Event- June 5
3296,2,11,13,CST,Morning Event- June 5
3297,6,11,17,CST,Morning Event- June 5
3298,5,11,16,CST,Morning Event- June 5
3300,11,11,22,EST,Morning Event- June 5
3301,4,11,15,EST,Morning Event- June 5
3302,6,11,17,CST,Morning Event- June 5
3303,10,5,15,EST,Morning Event- June 5
3304,10,11,21,EST,Morning Event- June 5
3305,4,5,9,EST,Morning Event- June 5
3307,3,6,9,EST,Morning Event- June 5
3308,6,11,17,EST,Morning Event- June 5
3309,4,5,9,EST,Morning Event- June 5
3310,2,11,13,EST,Morning Event- June 5
3311,2,6,8,EST,Morning Event- June 5
3319,6,11,17,CST,Morning Event- June 5
3320,3,16,19,CST,Morning Event- June 5
3322,3,5,8,CST,Morning Event- June 5
3324,5,11,16,CST,Morning Event- June 5
3328,5,11,16,EST,Morning Event- June 5
3329,10,11,21,EST,Morning Event- June 5
3331,8,11,19,CST,Morning Event- June 5
3332,3,17,20,EST,Morning Event- June 5
3334,9,11,20,EST,Morning Event- June 5
3336,6,11,17,EST,Morning Event- June 5
3337,2,17,19,EST,Morning Event- June 5
3339,3,11,14,EST,Morning Event- June 5
3342,3,11,14,EST,Morning Event- June 5
3344,5,11,16,EST,Morning Event- June 5
3347,5,11,16,EST,Morning Event- June 5
3348,4,5,9,EST,Morning Event- June 5
3349,6,11,17,EST,Morning Event- June 5
3362,3,11,14,CST,Morning Event- June 5
3363,5,11,16,CST,Morning Event- June 5
3364,3,5,8,CST,Morning Event- June 5
3367,5,5,10,EST,Morning Event- June 5
3370,2,11,13,EST,Morning Event- June 5
3371,3,5,8,EST,Morning Event- June 5
3372,2,6,8,EST,Morning Event- June 5
3381,6,5,11,CST,Morning Event- June 5
3383,4,11,15,CST,Morning Event- June 5
3384,7,5,12,CST,Morning Event- June 5
3386,6,5,11,CST,Morning Event- June 5
3387,6,11,17,EST,Morning Event- June 5
3388,3,5,8,EST,Morning Event- June 5
3389,6,5,11,EST,Morning Event- June 5
3390,6,11,17,CST,Morning Event- June 5
3391,4,11,15,CST,Morning Event- June 5
3394,8,5,13,CST,Morning Event- June 5
3395,10,11,21,CST,Morning Event- June 5
3397,3,5,8,EST,Morning Event- June 5
3400,6,11,17,CST,Morning Event- June 5
3401,5,5,10,EST,Morning Event- June 5
3402,6,11,17,EST,Morning Event- June 5
3403,3,11,14,EST,Morning Event- June 5
3404,6,11,17,CST,Morning Event- June 5
3406,6,5,11,CST,Morning Event- June 5
3409,3,11,14,EST,Morning Event- June 5
3412,4,11,15,EST,Morning Event- June 5
3415,6,5,11,EST,Morning Event- June 5
3417,5,6,11,EST,Morning Event- June 5
3418,4,11,15,EST,Morning Event- June 5
3420,5,11,16,EST,Morning Event- June 5
3422,5,11,16,EST,Morning Event- June 5
3425,6,11,17,CST,Morning Event- June 5
3429,4,11,15,EST,Morning Event- June 5
3430,6,5,11,CST,Morning Event- June 5
3431,6,11,17,CST,Morning Event- June 5
3432,6,5,11,CST,Morning Event- June 5
3433,5,5,10,CST,Morning Event- June 5
3434,5,11,16,CST,Morning Event- June 5
3435,3,11,14,EST,Morning Event- June 5
3436,6,11,17,EST,Morning Event- June 5
3439,2,12,14,CST,Morning Event- June 5
3443,6,11,17,EST,Morning Event- June 5
3445,4,11,15,EST,Morning Event- June 5
3447,2,6,8,EST,Morning Event- June 5
3453,4,11,15,EST,Morning Event- June 5
3458,5,5,10,EST,Morning Event- June 5
3459,4,11,15,CST,Morning Event- June 5
3460,5,11,16,CST,Morning Event- June 5
3461,5,11,16,EST,Morning Event- June 5
3462,6,11,17,EST,Morning Event- June 5
3463,2,11,13,EST,Morning Event- June 5
3469,5,18,23,EST,Morning Event- June 5
3471,6,11,17,EST,Morning Event- June 5
3474,2,11,13,EST,Morning Event- June 5
3475,3,11,14,EST,Morning Event- June 5
3476,2,11,13,EST,Morning Event- June 5
3480,9,11,20,EST,Morning Event- June 5
3481,2,5,7,EST,Morning Event- June 5
3482,6,5,11,CST,Morning Event- June 5
3483,4,5,9,CST,Morning Event- June 5
3484,2,6,8,CST,Morning Event- June 5
3485,11,11,22,EST,Morning Event- June 5
3486,2,17,19,EST,Morning Event- June 5
3487,2,11,13,EST,Morning Event- June 5
3488,5,11,16,CST,Morning Event- June 5
3489,5,6,11,EST,Morning Event- June 5
3490,4,11,15,EST,Morning Event- June 5
3491,6,11,17,EST,Morning Event- June 5
3492,6,11,17,CST,Morning Event- June 5
3495,4,16,20,CST,Morning Event- June 5
3497,2,5,7,CST,Morning Event- June 5
3498,5,5,10,CST,Morning Event- June 5
3499,3,6,9,CST,Morning Event- June 5
3500,5,16,21,CST,Morning Event- June 5
3501,5,5,10,EST,Morning Event- June 5
3502,6,11,17,EST,Morning Event- June 5
3503,6,11,17,EST,Morning Event- June 5
3505,7,11,18,CST,Morning Event- June 5
3510,5,11,16,CST,Morning Event- June 5
3513,3,11,14,CST,Morning Event- June 5
3514,9,11,20,EST,Morning Event- June 5
3515,5,11,16,EST,Morning Event- June 5
3518,3,18,21,CST,Morning Event- June 5
3520,3,23,26,EST,Morning Event- June 5
3526,5,11,16,EST,Morning Event- June 5
3527,3,11,14,EST,Morning Event- June 5
3528,7,5,12,CST,Morning Event- June 5
3529,2,6,8,EST,Morning Event- June 5
3534,6,5,11,CST,Morning Event- June 5
3535,4,11,15,EST,Morning Event- June 5
3538,2,11,13,EST,Morning Event- June 5
3541,4,11,15,EST,Morning Event- June 5
3543,5,11,16,EST,Morning Event- June 5
3545,5,6,11,EST,Morning Event- June 5
3546,4,11,15,EST,Morning Event- June 5
3548,5,11,16,EST,Morning Event- June 5
3549,5,11,16,EST,Morning Event- June 5
3560,5,11,16,EST,Morning Event- June 5
3561,6,11,17,EST,Morning Event- June 5
3562,3,11,14,EST,Morning Event- June 5
3563,6,11,17,EST,Morning Event- June 5
3564,6,6,12,EST,Morning Event- June 5
3567,6,11,17,CST,Morning Event- June 5
3569,6,11,17,CST,Morning Event- June 5
3570,6,11,17,EST,Morning Event- June 5
3571,5,11,16,EST,Morning Event- June 5
3572,6,11,17,CST,Morning Event- June 5
3573,6,11,17,EST,Morning Event- June 5
3580,5,11,16,EST,Morning Event- June 5
3581,7,11,18,EST,Morning Event- June 5
3583,2,11,13,EST,Morning Event- June 5
3584,2,11,13,CST,Morning Event- June 5
3585,2,11,13,CST,Morning Event- June 5
3588,3,6,9,EST,Morning Event- June 5
3590,11,11,22,CST,Morning Event- June 5
3591,6,11,17,CST,Morning Event- June 5
3595,6,11,17,EST,Morning Event- June 5
3597,4,11,15,CST,Morning Event- June 5
3598,2,11,13,EST,Morning Event- June 5
3601,5,11,16,CST,Morning Event- June 5
3602,3,11,14,CST,Morning Event- June 5
3607,2,5,7,EST,Morning Event- June 5
3608,2,11,13,EST,Morning Event- June 5
3609,6,6,12,EST,Morning Event- June 5
3611,5,5,10,EST,Morning Event- June 5
3612,3,6,9,EST,Morning Event- June 5
3616,6,5,11,CST,Morning Event- June 5
3621,4,11,15,EST,Morning Event- June 5
3623,6,11,17,CST,Morning Event- June 5
3624,3,11,14,CST,Morning Event- June 5
3625,6,6,12,EST,Morning Event- June 5
3626,5,11,16,EST,Morning Event- June 5
3627,3,11,14,EST,Morning Event- June 5
3630,3,11,14,CST,Morning Event- June 5
3631,4,11,15,CST,Morning Event- June 5
3632,7,5,12,EST,Morning Event- June 5
3633,6,11,17,EST,Morning Event- June 5
3634,6,6,12,EST,Morning Event- June 5
3639,2,11,13,EST,Morning Event- June 5
3640,5,11,16,CST,Morning Event- June 5
3641,6,5,11,EST,Morning Event- June 5
3643,7,5,12,CST,Morning Event- June 5
3644,5,6,11,EST,Morning Event- June 5
3645,14,16,30,CST,Morning Event- June 5
3648,2,11,13,CST,Morning Event- June 5
3658,3,6,9,EST,Morning Event- June 5
3659,5,11,16,EST,Morning Event- June 5
3660,6,11,17,EST,Morning Event- June 5
3693,50,125,175,AST,Morning Event- June 5
3700,6,11,17,EST,Morning Event- June 5
3701,6,5,11,EST,Morning Event- June 5
3702,5,11,16,EST,Morning Event- June 5
3709,5,5,10,EST,Morning Event- June 5
3710,5,6,11,EST,Morning Event- June 5
3716,65,180,245,AST,Morning Event- June 5
3717,2,6,8,CST,Morning Event- June 5
3720,2,6,8,EST,Morning Event- June 5
3722,4,11,15,EST,Morning Event- June 5
3725,3,11,14,CST,Morning Event- June 5
3726,4,16,20,EST,Morning Event- June 5
3733,5,11,16,EST,Morning Event- June 5
3734,5,5,10,CST,Morning Event- June 5
3738,5,11,16,EST,Morning Event- June 5
3741,4,5,9,EST,Morning Event- June 5
3747,4,6,10,EST,Morning Event- June 5
3748,5,11,16,EST,Morning Event- June 5
3749,5,5,10,EST,Morning Event- June 5
3750,2,11,13,EST,Morning Event- June 5
3758,3,5,8,CST,Morning Event- June 5
3760,7,6,13,CST,Morning Event- June 5
3761,4,6,10,CST,Morning Event- June 5
3762,2,16,18,CST,Morning Event- June 5
3764,11,11,22,CST,Morning Event- June 5
3765,6,6,12,EST,Morning Event- June 5
3768,6,5,11,EST,Morning Event- June 5
3770,3,5,8,EST,Morning Event- June 5
3772,2,5,7,EST,Morning Event- June 5
3773,4,11,15,CST,Morning Event- June 5
3774,3,6,9,EST,Morning Event- June 5
3777,3,6,9,CST,Morning Event- June 5
3780,3,6,9,EST,Morning Event- June 5
3781,2,5,7,EST,Morning Event- June 5
3782,6,16,22,EST,Morning Event- June 5
3783,2,6,8,EST,Morning Event- June 5
3784,3,11,14,EST,Morning Event- June 5
3785,6,5,11,CST,Morning Event- June 5
3786,3,11,14,EST,Morning Event- June 5
3790,3,6,9,CST,Morning Event- June 5
3791,7,11,18,EST,Morning Event- June 5
3792,6,11,17,EST,Morning Event- June 5
3795,5,18,23,EST,Morning Event- June 5
3802,3,11,14,EST,Morning Event- June 5
3803,3,11,14,EST,Morning Event- June 5
3804,2,5,7,EST,Morning Event- June 5
3806,8,11,19,CST,Morning Event- June 5
3809,2,5,7,EST,Morning Event- June 5
3810,6,5,11,EST,Morning Event- June 5
3812,2,6,8,EST,Morning Event- June 5
3823,4,11,15,CST,Morning Event- June 5
3825,4,11,15,EST,Morning Event- June 5
3826,6,11,17,CST,Morning Event- June 5
3827,6,11,17,CST,Morning Event- June 5
3828,8,11,19,CST,Morning Event- June 5
3829,2,11,13,EST,Morning Event- June 5
3830,4,6,10,EST,Morning Event- June 5
3831,6,5,11,EST,Morning Event- June 5
3835,3,11,14,EST,Morning Event- June 5
3837,4,6,10,CST,Morning Event- June 5
3838,2,11,13,EST,Morning Event- June 5
3840,2,11,13,EST,Morning Event- June 5
3842,3,11,14,EST,Morning Event- June 5
3843,6,11,17,EST,Morning Event- June 5
3851,6,11,17,EST,Morning Event- June 5
3852,5,5,10,EST,Morning Event- June 5
3853,6,5,11,CST,Morning Event- June 5
3857,3,11,14,CST,Morning Event- June 5
3858,3,5,8,EST,Morning Event- June 5
3860,5,11,16,EST,Morning Event- June 5
3864,10,11,21,EST,Morning Event- June 5
3868,6,6,12,CST,Morning Event- June 5
3869,5,5,10,EST,Morning Event- June 5
3874,3,16,19,EST,Morning Event- June 5
3875,7,5,12,CST,Morning Event- June 5
3876,4,5,9,EST,Morning Event- June 5
3877,6,6,12,EST,Morning Event- June 5
3886,2,16,18,CST,Morning Event- June 5
3887,9,11,20,EST,Morning Event- June 5
3888,3,18,21,CST,Morning Event- June 5
3889,4,5,9,EST,Morning Event- June 5
3891,2,16,18,CST,Morning Event- June 5
3893,6,11,17,CST,Morning Event- June 5
3894,4,11,15,EST,Morning Event- June 5
3912,4,11,15,EST,Morning Event- June 5
4049,2,5,7,CST,Morning Event- June 5
4055,4,11,15,CST,Morning Event- June 5
4063,6,5,11,EST,Morning Event- June 5
4064,3,11,14,EST,Morning Event- June 5
4065,2,11,13,EST,Morning Event- June 5
4102,5,5,10,CST,Morning Event- June 5
4103,3,6,9,CST,Morning Event- June 5
4108,12,20,32,CST,Morning Event- June 5
4111,6,11,17,CST,Morning Event- June 5
4112,4,16,20,CST,Morning Event- June 5
4115,2,11,13,CST,Morning Event- June 5
4118,6,11,17,EST,Morning Event- June 5
4129,6,5,11,CST,Morning Event- June 5
4130,3,11,14,CST,Morning Event- June 5
4131,4,6,10,CST,Morning Event- June 5
4144,6,5,11,EST,Morning Event- June 5
4153,3,6,9,EST,Morning Event- June 5
4156,8,11,19,EST,Morning Event- June 5
4161,3,11,14,EST,Morning Event- June 5
4162,2,11,13,CST,Morning Event- June 5
4163,6,11,17,CST,Morning Event- June 5
4164,9,11,20,CST,Morning Event- June 5
4165,6,5,11,CST,Morning Event- June 5
4166,4,6,10,EST,Morning Event- June 5
4168,3,11,14,CST,Morning Event- June 5
4183,3,11,14,CST,Morning Event- June 5
4185,6,5,11,EST,Morning Event- June 5
4187,7,5,12,CST,Morning Event- June 5
4191,5,5,10,EST,Morning Event- June 5
4194,6,11,17,CST,Morning Event- June 5
4195,6,11,17,CST,Morning Event- June 5
4200,6,6,12,EST,Morning Event- June 5
4209,6,5,11,CST,Morning Event- June 5
4215,3,5,8,CST,Morning Event- June 5
4216,5,11,16,EST,Morning Event- June 5
4219,6,11,17,CST,Morning Event- June 5
4223,2,11,13,EST,Morning Event- June 5
4224,2,16,18,EST,Morning Event- June 5
4226,5,5,10,CST,Morning Event- June 5
4230,2,11,13,EST,Morning Event- June 5
4231,5,5,10,EST,Morning Event- June 5
4235,2,16,18,EST,Morning Event- June 5
4237,6,11,17,EST,Morning Event- June 5
4240,6,11,17,CST,Morning Event- June 5
4241,8,11,19,CST,Morning Event- June 5
4243,2,16,18,EST,Morning Event- June 5
4244,10,5,15,CST,Morning Event- June 5
4246,7,5,12,CST,Morning Event- June 5
4250,3,5,8,EST,Morning Event- June 5
4253,8,5,13,CST,Morning Event- June 5
4255,6,11,17,EST,Morning Event- June 5
4256,4,11,15,CST,Morning Event- June 5
4257,6,11,17,CST,Morning Event- June 5
4258,4,6,10,EST,Morning Event- June 5
4259,6,5,11,CST,Morning Event- June 5
4260,5,11,16,EST,Morning Event- June 5
4262,4,11,15,EST,Morning Event- June 5
4273,6,11,17,EST,Morning Event- June 5
4274,4,11,15,EST,Morning Event- June 5
4276,5,16,21,EST,Morning Event- June 5
4277,5,11,16,EST,Morning Event- June 5
4278,6,6,12,EST,Morning Event- June 5
4279,4,11,15,CST,Morning Event- June 5
4281,3,5,8,CST,Morning Event- June 5
4283,6,11,17,EST,Morning Event- June 5
4285,4,5,9,EST,Morning Event- June 5
4286,6,11,17,CST,Morning Event- June 5
4295,6,5,11,CST,Morning Event- June 5
4298,6,11,17,CST,Morning Event- June 5
4299,3,11,14,CST,Morning Event- June 5
4303,5,11,16,EST,Morning Event- June 5
4318,2,11,13,CST,Morning Event- June 5
4321,3,11,14,CST,Morning Event- June 5
4322,5,5,10,CST,Morning Event- June 5
4323,2,5,7,CST,Morning Event- June 5
4330,6,6,12,CST,Morning Event- June 5
4332,6,28,34,EST,Morning Event- June 5
4333,6,16,22,CST,Morning Event- June 5
4334,2,11,13,EST,Morning Event- June 5
4348,6,11,17,EST,Morning Event- June 5
4350,6,5,11,EST,Morning Event- June 5
4352,3,17,20,CST,Morning Event- June 5
4358,3,11,14,CST,Morning Event- June 5
4365,2,16,18,EST,Morning Event- June 5
4368,5,11,16,EST,Morning Event- June 5
4372,6,5,11,EST,Morning Event- June 5
4374,9,5,14,CST,Morning Event- June 5
4378,8,5,13,EST,Morning Event- June 5
4381,8,11,19,CST,Morning Event- June 5
4383,6,11,17,EST,Morning Event- June 5
4384,4,5,9,EST,Morning Event- June 5
4387,5,11,16,EST,Morning Event- June 5
4389,6,6,12,EST,Morning Event- June 5
4399,3,11,14,EST,Morning Event- June 5
4403,3,11,14,EST,Morning Event- June 5
4404,4,11,15,EST,Morning Event- June 5
4405,3,6,9,CST,Morning Event- June 5
4407,6,5,11,CST,Morning Event- June 5
4409,6,11,17,EST,Morning Event- June 5
4410,5,11,16,EST,Morning Event- June 5
4414,4,5,9,CST,Morning Event- June 5
4416,4,11,15,CST,Morning Event- June 5
4417,6,11,17,EST,Morning Event- June 5
4420,5,6,11,EST,Morning Event- June 5
4423,4,16,20,EST,Morning Event- June 5
4424,3,11,14,EST,Morning Event- June 5
4427,5,5,10,EST,Morning Event- June 5
4428,3,11,14,EST,Morning Event- June 5
4435,3,5,8,CST,Morning Event- June 5
4436,6,5,11,EST,Morning Event- June 5
4439,5,5,10,EST,Morning Event- June 5
4440,2,11,13,EST,Morning Event- June 5
4444,3,11,14,EST,Morning Event- June 5
4446,4,5,9,EST,Morning Event- June 5
4450,3,5,8,EST,Morning Event- June 5
4456,3,11,14,EST,Morning Event- June 5
4457,3,5,8,EST,Morning Event- June 5
4458,3,6,9,EST,Morning Event- June 5
4459,6,5,11,EST,Morning Event- June 5
4460,5,6,11,CST,Morning Event- June 5
4461,2,5,7,EST,Morning Event- June 5
4472,6,5,11,EST,Morning Event- June 5
4475,3,11,14,CST,Morning Event- June 5
4476,3,6,9,EST,Morning Event- June 5
4477,3,6,9,EST,Morning Event- June 5
4479,2,11,13,EST,Morning Event- June 5
4482,5,11,16,CST,Morning Event- June 5
4483,4,11,15,CST,Morning Event- June 5
4484,2,5,7,EST,Morning Event- June 5
4487,4,11,15,EST,Morning Event- June 5
4497,6,5,11,CST,Morning Event- June 5
4499,6,6,12,EST,Morning Event- June 5
4501,5,5,10,EST,Morning Event- June 5
4503,3,11,14,CST,Morning Event- June 5
4506,5,5,10,EST,Morning Event- June 5
4508,2,11,13,CST,Morning Event- June 5
4509,5,11,16,CST,Morning Event- June 5
4511,5,11,16,CST,Morning Event- June 5
4512,6,11,17,CST,Morning Event- June 5
4514,6,5,11,EST,Morning Event- June 5
4520,6,11,17,EST,Morning Event- June 5
4521,3,11,14,EST,Morning Event- June 5
4526,4,11,15,CST,Morning Event- June 5
4529,2,6,8,CST,Morning Event- June 5
4531,4,11,15,CST,Morning Event- June 5
4533,6,5,11,CST,Morning Event- June 5
4538,2,11,13,CST,Morning Event- June 5
4540,4,6,10,EST,Morning Event- June 5
4553,3,11,14,CST,Morning Event- June 5
4554,3,6,9,CST,Morning Event- June 5
4556,5,5,10,EST,Morning Event- June 5
4558,4,5,9,EST,Morning Event- June 5
4564,6,6,12,EST,Morning Event- June 5
4568,6,5,11,CST,Morning Event- June 5
4569,5,5,10,CST,Morning Event- June 5
4570,4,5,9,EST,Morning Event- June 5
4574,4,11,15,EST,Morning Event- June 5
4581,6,5,11,CST,Morning Event- June 5
4583,4,11,15,EST,Morning Event- June 5
4588,2,11,13,EST,Morning Event- June 5
4590,5,11,16,CST,Morning Event- June 5
4593,5,11,16,EST,Morning Event- June 5
4594,3,6,9,EST,Morning Event- June 5
4597,6,11,17,EST,Morning Event- June 5
4600,3,11,14,CST,Morning Event- June 5
4606,5,10,15,CST,Morning Event- June 5
4609,4,6,10,EST,Morning Event- June 5
4611,5,5,10,CST,Morning Event- June 5
4612,5,11,16,EST,Morning Event- June 5
4615,2,11,13,CST,Morning Event- June 5
4616,6,11,17,EST,Morning Event- June 5
4623,6,5,11,EST,Morning Event- June 5
4627,2,11,13,CST,Morning Event- June 5
4631,6,16,22,CST,Morning Event- June 5
4635,6,11,17,EST,Morning Event- June 5
4636,2,5,7,EST,Morning Event- June 5
4637,2,11,13,CST,Morning Event- June 5
4638,4,5,9,EST,Morning Event- June 5
4641,4,6,10,CST,Morning Event- June 5
4643,5,5,10,EST,Morning Event- June 5
4644,2,6,8,EST,Morning Event- June 5
4660,5,11,16,EST,Morning Event- June 5
4664,6,11,17,EST,Morning Event- June 5
4677,2,5,7,CST,Morning Event- June 5
4679,2,5,7,CST,Morning Event- June 5
4681,6,5,11,EST,Morning Event- June 5
4682,5,11,16,EST,Morning Event- June 5
4683,2,5,7,CST,Morning Event- June 5
4687,3,6,9,EST,Morning Event- June 5
4690,4,5,9,EST,Morning Event- June 5
4695,6,6,12,CST,Morning Event- June 5
4697,5,6,11,EST,Morning Event- June 5
4699,2,5,7,CST,Morning Event- June 5
4849,7,11,18,CST,Morning Event- June 5
4865,6,11,17,CST,Morning Event- June 5
5012,4,11,15,EST,Morning Event- June 5
5022,2,5,7,CST,Morning Event- June 5
5025,3,11,14,EST,Morning Event- June 5
5027,3,11,14,EST,Morning Event- June 5
5028,6,11,17,EST,Morning Event- June 5
5029,6,11,17,EST,Morning Event- June 5
5030,2,11,13,EST,Morning Event- June 5
5034,5,11,16,EST,Morning Event- June 5
5035,3,11,14,EST,Morning Event- June 5
5036,2,11,13,EST,Morning Event- June 5
5037,3,11,14,EST,Morning Event- June 5
5039,2,11,13,EST,Morning Event- June 5
5040,3,11,14,EST,Morning Event- June 5
5044,6,5,11,CST,Morning Event- June 5
5045,6,11,17,CST,Morning Event- June 5
5046,2,11,13,EST,Morning Event- June 5
5047,3,5,8,EST,Morning Event- June 5
5048,3,11,14,EST,Morning Event- June 5
5054,2,11,13,EST,Morning Event- June 5
5055,4,6,10,EST,Morning Event- June 5
5056,5,11,16,CST,Morning Event- June 5
5057,2,11,13,CST,Morning Event- June 5
5058,4,6,10,CST,Morning Event- June 5
5060,4,11,15,CST,Morning Event- June 5
5063,5,5,10,EST,Morning Event- June 5
5064,4,6,10,EST,Morning Event- June 5
5065,2,6,8,EST,Morning Event- June 5
5066,4,11,15,EST,Morning Event- June 5
5071,16,16,32,CST,Morning Event- June 5
5076,2,11,13,EST,Morning Event- June 5
5077,3,6,9,EST,Morning Event- June 5
5079,3,11,14,CST,Morning Event- June 5
5080,5,11,16,CST,Morning Event- June 5
5082,6,11,17,EST,Morning Event- June 5
5085,4,11,15,EST,Morning Event- June 5
5087,5,11,16,EST,Morning Event- June 5
5088,4,11,15,EST,Morning Event- June 5
5089,4,5,9,CST,Morning Event- June 5
5090,3,11,14,CST,Morning Event- June 5
5091,2,16,18,CST,Morning Event- June 5
5092,6,6,12,CST,Morning Event- June 5
5095,2,16,18,EST,Morning Event- June 5
5097,3,11,14,EST,Morning Event- June 5
5103,2,11,13,EST,Morning Event- June 5
5104,5,6,11,EST,Morning Event- June 5
5105,5,11,16,EST,Morning Event- June 5
5111,2,11,13,EST,Morning Event- June 5
5113,6,11,17,CST,Morning Event- June 5
5115,5,11,16,CST,Morning Event- June 5
5116,6,11,17,CST,Morning Event- June 5
5117,5,11,16,EST,Morning Event- June 5
5118,3,5,8,EST,Morning Event- June 5
5126,6,5,11,CST,Morning Event- June 5
5127,5,11,16,CST,Morning Event- June 5
5129,2,11,13,EST,Morning Event- June 5
5130,3,11,14,EST,Morning Event- June 5
5131,5,11,16,EST,Morning Event- June 5
5141,6,11,17,CST,Morning Event- June 5
5142,3,11,14,EST,Morning Event- June 5
5144,2,11,13,CST,Morning Event- June 5
5145,5,11,16,CST,Morning Event- June 5
5146,6,11,17,CST,Morning Event- June 5
5147,3,11,14,CST,Morning Event- June 5
5150,5,11,16,CST,Morning Event- June 5
5151,6,16,22,EST,Morning Event- June 5
5157,5,5,10,CST,Morning Event- June 5
5159,11,11,22,EST,Morning Event- June 5
5160,6,16,22,EST,Morning Event- June 5
5165,4,16,20,CST,Morning Event- June 5
5172,8,5,13,EST,Morning Event- June 5
5173,3,16,19,EST,Morning Event- June 5
5174,3,6,9,CST,Morning Event- June 5
5175,7,11,18,CST,Morning Event- June 5
5178,5,6,11,EST,Morning Event- June 5
5184,5,11,16,EST,Morning Event- June 5
5185,5,11,16,EST,Morning Event- June 5
5191,3,11,14,CST,Morning Event- June 5
5196,5,5,10,CST,Morning Event- June 5
5197,4,6,10,CST,Morning Event- June 5
5199,4,11,15,CST,Morning Event- June 5
5200,2,11,13,EST,Morning Event- June 5
5201,4,6,10,EST,Morning Event- June 5
5202,5,11,16,EST,Morning Event- June 5
5203,6,11,17,EST,Morning Event- June 5
5210,5,5,10,CST,Morning Event- June 5
5211,4,6,10,CST,Morning Event- June 5
5214,3,23,26,EST,Morning Event- June 5
5216,15,11,26,CST,Morning Event- June 5
5218,6,6,12,EST,Morning Event- June 5
5219,4,5,9,CST,Morning Event- June 5
5220,6,6,12,EST,Morning Event- June 5
5227,5,11,16,EST,Morning Event- June 5
5228,2,5,7,EST,Morning Event- June 5
5229,10,5,15,EST,Morning Event- June 5
5236,5,11,16,CST,Morning Event- June 5
5239,5,11,16,EST,Morning Event- June 5
5240,2,11,13,EST,Morning Event- June 5
5241,4,11,15,EST,Morning Event- June 5
5242,2,16,18,EST,Morning Event- June 5
5244,4,5,9,CST,Morning Event- June 5
5245,6,16,22,CST,Morning Event- June 5
5246,7,5,12,CST,Morning Event- June 5
5247,4,11,15,CST,Morning Event- June 5
5250,3,11,14,EST,Morning Event- June 5
5251,4,11,15,EST,Morning Event- June 5
5252,4,11,15,EST,Morning Event- June 5
5253,4,5,9,EST,Morning Event- June 5
5254,2,11,13,EST,Morning Event- June 5
5260,4,18,22,CST,Morning Event- June 5
5261,5,11,16,CST,Morning Event- June 5
5262,4,5,9,CST,Morning Event- June 5
5263,6,11,17,EST,Morning Event- June 5
5264,6,5,11,EST,Morning Event- June 5
5266,6,11,17,EST,Morning Event- June 5
5275,4,16,20,EST,Morning Event- June 5
5276,3,5,8,CST,Morning Event- June 5
5278,3,17,20,EST,Morning Event- June 5
5280,4,6,10,EST,Morning Event- June 5
5281,5,11,16,EST,Morning Event- June 5
5282,10,5,15,EST,Morning Event- June 5
5285,5,6,11,EST,Morning Event- June 5
5287,3,11,14,CST,Morning Event- June 5
5288,3,11,14,CST,Morning Event- June 5
5292,5,5,10,EST,Morning Event- June 5
5293,2,18,20,EST,Morning Event- June 5
5294,3,11,14,EST,Morning Event- June 5
5295,3,11,14,EST,Morning Event- June 5
5296,2,11,13,EST,Morning Event- June 5
5298,6,6,12,EST,Morning Event- June 5
5299,2,16,18,EST,Morning Event- June 5
5300,3,11,14,EST,Morning Event- June 5
5301,6,6,12,EST,Morning Event- June 5
5307,5,11,16,CST,Morning Event- June 5
5309,3,5,8,EST,Morning Event- June 5
5311,6,6,12,CST,Morning Event- June 5
5312,6,11,17,CST,Morning Event- June 5
5313,6,11,17,CST,Morning Event- June 5
5316,5,11,16,CST,Morning Event- June 5
5317,5,11,16,CST,Morning Event- June 5
5319,7,11,18,EST,Morning Event- June 5
5320,5,6,11,EST,Morning Event- June 5
5325,2,6,8,EST,Morning Event- June 5
5326,4,11,15,EST,Morning Event- June 5
5340,5,11,16,EST,Morning Event- June 5
5343,6,11,17,EST,Morning Event- June 5
5345,2,6,8,EST,Morning Event- June 5
5346,5,5,10,EST,Morning Event- June 5
5347,2,11,13,EST,Morning Event- June 5
5348,2,5,7,CST,Morning Event- June 5
5352,2,5,7,CST,Morning Event- June 5
5355,5,5,10,EST,Morning Event- June 5
5356,6,5,11,EST,Morning Event- June 5
5358,4,6,10,EST,Morning Event- June 5
5359,4,11,15,CST,Morning Event- June 5
5360,5,5,10,EST,Morning Event- June 5
5361,2,11,13,CST,Morning Event- June 5
5363,2,5,7,EST,Morning Event- June 5
5373,3,17,20,CST,Morning Event- June 5
5374,6,6,12,EST,Morning Event- June 5
5376,10,11,21,EST,Morning Event- June 5
5379,2,11,13,EST,Morning Event- June 5
5381,4,6,10,EST,Morning Event- June 5
5382,3,11,14,EST,Morning Event- June 5
5384,4,6,10,EST,Morning Event- June 5
5385,8,11,19,EST,Morning Event- June 5
5386,3,6,9,EST,Morning Event- June 5
5387,5,11,16,EST,Morning Event- June 5
5388,5,11,16,CST,Morning Event- June 5
5389,6,11,17,CST,Morning Event- June 5
5390,2,6,8,EST,Morning Event- June 5
5391,5,11,16,EST,Morning Event- June 5
5392,6,5,11,EST,Morning Event- June 5
5397,6,11,17,CST,Morning Event- June 5
5398,4,5,9,CST,Morning Event- June 5
5399,6,6,12,CST,Morning Event- June 5
5402,2,11,13,CST,Morning Event- June 5
5403,4,11,15,CST,Morning Event- June 5
5409,4,11,15,EST,Morning Event- June 5
5410,5,11,16,EST,Morning Event- June 5
5411,6,11,17,EST,Morning Event- June 5
5414,6,11,17,EST,Morning Event- June 5
5416,4,11,15,CST,Morning Event- June 5
5417,4,6,10,EST,Morning Event- June 5
5418,2,5,7,EST,Morning Event- June 5
5419,4,5,9,CST,Morning Event- June 5
5420,2,23,25,EST,Morning Event- June 5
5422,2,5,7,EST,Morning Event- June 5
5432,3,11,14,CST,Morning Event- June 5
5433,4,5,9,CST,Morning Event- June 5
5436,3,6,9,EST,Morning Event- June 5
5438,6,5,11,CST,Morning Event- June 5
5439,4,5,9,EST,Morning Event- June 5
5441,4,6,10,CST,Morning Event- June 5
5442,4,5,9,CST,Morning Event- June 5
5443,2,11,13,EST,Morning Event- June 5
5444,6,5,11,CST,Morning Event- June 5
5445,5,5,10,EST,Morning Event- June 5
5446,5,5,10,EST,Morning Event- June 5
5447,2,18,20,EST,Morning Event- June 5
5448,2,6,8,EST,Morning Event- June 5
5449,3,11,14,CST,Morning Event- June 5
5450,3,11,14,EST,Morning Event- June 5
5455,4,11,15,EST,Morning Event- June 5
5460,7,11,18,CST,Morning Event- June 5
5463,3,6,9,CST,Morning Event- June 5
5466,2,16,18,EST,Morning Event- June 5
5469,2,11,13,EST,Morning Event- June 5
5470,2,6,8,EST,Morning Event- June 5
5471,2,11,13,EST,Morning Event- June 5
5472,2,11,13,EST,Morning Event- June 5
5476,5,11,16,EST,Morning Event- June 5
5477,6,11,17,CST,Morning Event- June 5
5479,5,11,16,CST,Morning Event- June 5
5480,4,16,20,CST,Morning Event- June 5
5481,3,5,8,EST,Morning Event- June 5
5482,3,5,8,EST,Morning Event- June 5
5483,4,6,10,EST,Morning Event- June 5
5485,5,11,16,CST,Morning Event- June 5
5486,6,5,11,CST,Morning Event- June 5
5487,6,11,17,EST,Morning Event- June 5
5488,3,11,14,EST,Morning Event- June 5
5489,6,5,11,EST,Morning Event- June 5
5495,6,5,11,EST,Morning Event- June 5
5497,12,11,23,EST,Morning Event- June 5
5498,4,5,9,EST,Morning Event- June 5
5499,3,11,14,EST,Morning Event- June 5
5612,3,11,14,CST,Morning Event- June 5
5616,3,5,8,CST,Morning Event- June 5
5617,4,11,15,CST,Morning Event- June 5
5649,4,5,9,EST,Morning Event- June 5
5667,3,6,9,CST,Morning Event- June 5
5668,2,5,7,CST,Morning Event- June 5
5669,2,6,8,CST,Morning Event- June 5
5671,5,11,16,EST,Morning Event- June 5
5672,5,5,10,CST,Morning Event- June 5
5673,2,5,7,CST,Morning Event- June 5
5703,6,11,17,CST,Morning Event- June 5
5705,6,5,11,EST,Morning Event- June 5
5706,3,5,8,CST,Morning Event- June 5
5707,5,11,16,CST,Morning Event- June 5
5709,4,11,15,EST,Morning Event- June 5
5713,2,17,19,CST,Morning Event- June 5
5727,2,11,13,EST,Morning Event- June 5
5728,5,11,16,CST,Morning Event- June 5
5731,5,5,10,EST,Morning Event- June 5
5732,4,11,15,EST,Morning Event- June 5
5735,4,11,15,EST,Morning Event- June 5
5743,4,11,15,EST,Morning Event- June 5
5745,3,11,14,EST,Morning Event- June 5
5747,2,11,13,EST,Morning Event- June 5
5748,6,11,17,CST,Morning Event- June 5
5752,4,17,21,EST,Morning Event- June 5
5753,4,6,10,EST,Morning Event- June 5
5761,3,5,8,EST,Morning Event- June 5
5764,5,11,16,CST,Morning Event- June 5
5772,2,11,13,EST,Morning Event- June 5
5777,5,6,11,EST,Morning Event- June 5
5779,4,5,9,EST,Morning Event- June 5
5786,6,6,12,EST,Morning Event- June 5
5787,3,5,8,EST,Morning Event- June 5
5793,55,150,205,AST,Morning Event- June 5
5795,4,11,15,EST,Morning Event- June 5
5797,6,5,11,EST,Morning Event- June 5
5802,55,160,215,AST,Morning Event- June 5
5803,70,200,270,AST,Morning Event- June 5
5806,3,5,8,CST,Morning Event- June 5
5808,5,11,16,CST,Morning Event- June 5
5809,6,16,22,CST,Morning Event- June 5
5810,3,5,8,CST,Morning Event- June 5
5812,7,11,18,EST,Morning Event- June 5
5814,4,11,15,EST,Morning Event- June 5
5823,2,5,7,CST,Morning Event- June 5
5842,2,11,13,EST,Morning Event- June 5
5844,3,11,14,EST,Morning Event- June 5
5845,4,11,15,CST,Morning Event- June 5
5847,3,5,8,EST,Morning Event- June 5
5851,5,6,11,EST,Morning Event- June 5
5854,5,11,16,EST,Morning Event- June 5
5857,3,5,8,EST,Morning Event- June 5
5866,5,5,10,CST,Morning Event- June 5
5867,2,16,18,EST,Morning Event- June 5
5871,3,5,8,EST,Morning Event- June 5
5872,4,5,9,CST,Morning Event- June 5
5879,2,5,7,EST,Morning Event- June 5
5880,3,6,9,EST,Morning Event- June 5
5881,2,5,7,EST,Morning Event- June 5
5882,3,11,14,EST,Morning Event- June 5
5888,3,11,14,EST,Morning Event- June 5
5889,5,5,10,CST,Morning Event- June 5
5891,4,11,15,EST,Morning Event- June 5
5893,3,11,14,EST,Morning Event- June 5
5894,2,6,8,EST,Morning Event- June 5
5898,3,16,19,CST,Morning Event- June 5
5911,4,5,9,EST,Morning Event- June 5
5912,4,5,9,EST,Morning Event- June 5
5922,3,5,8,EST,Morning Event- June 5
5927,6,5,11,CST,Morning Event- June 5
5932,4,11,15,EST,Morning Event- June 5
5936,3,11,14,EST,Morning Event- June 5
5944,2,5,7,EST,Morning Event- June 5
5959,3,11,14,CST,Morning Event- June 5
5964,4,11,15,EST,Morning Event- June 5
5965,5,6,11,CST,Morning Event- June 5
5968,4,11,15,EST,Morning Event- June 5
5969,2,6,8,EST,Morning Event- June 5
5976,4,6,10,CST,Morning Event- June 5
5977,4,5,9,CST,Morning Event- June 5
5987,5,11,16,CST,Morning Event- June 5
5992,5,5,10,CST,Morning Event- June 5
6173,6,6,12,CST,Morning Event- June 5
6190,2,11,13,EST,Morning Event- June 5
6286,2,11,13,CST,Morning Event- June 5
6300,6,11,17,CST,Morning Event- June 5
6370,8,11,19,EST,Morning Event- June 5
6392,2,5,7,CST,Morning Event- June 5
6394,4,5,9,CST,Morning Event- June 5
6395,5,5,10,EST,Morning Event- June 5
6397,5,11,16,EST,Morning Event- June 5
6467,8,11,19,CST,Morning Event- June 5
6469,8,5,13,CST,Morning Event- June 5
6476,3,5,8,EST,Morning Event- June 5
6576,6,5,11,EST,Morning Event- June 5
6579,6,11,17,CST,Morning Event- June 5
6789,5,11,16,EST,Morning Event- June 5
6807,6,5,11,CST,Morning Event- June 5
6878,6,16,22,CST,Morning Event- June 5
6879,4,11,15,EST,Morning Event- June 5
6887,4,5,9,EST,Morning Event- June 5
6898,6,11,17,CST,Morning Event- June 5
6929,6,11,17,CST,Morning Event- June 5
6930,15,11,26,CST,Morning Event- June 5
6931,5,5,10,EST,Morning Event- June 5
6932,2,5,7,CST,Morning Event- June 5
6951,9,5,14,EST,Morning Event- June 5
6952,5,5,10,EST,Morning Event- June 5
6958,6,11,17,EST,Morning Event- June 5
6963,4,11,15,CST,Morning Event- June 5
6964,6,5,11,CST,Morning Event- June 5
6978,4,11,15,EST,Morning Event- June 5
6998,3,5,8,EST,Morning Event- June 5
7009,5,11,16,EST,Morning Event- June 5
7020,5,5,10,CST,Morning Event- June 5
7032,4,5,9,EST,Morning Event- June 5
7087,6,6,12,EST,Morning Event- June 5
7156,6,11,17,CST,Morning Event- June 5
7178,6,6,12,CST,Morning Event- June 5
7179,5,11,16,EST,Morning Event- June 5
7181,8,5,13,EST,Morning Event- June 5
7185,6,6,12,EST,Morning Event- June 5
7188,6,5,11,EST,Morning Event- June 5
7194,6,5,11,EST,Morning Event- June 5
7238,2,5,7,EST,Morning Event- June 5
7243,5,5,10,EST,Morning Event- June 5
7245,5,5,10,EST,Morning Event- June 5
7246,2,5,7,EST,Morning Event- June 5
7247,4,5,9,CST,Morning Event- June 5
7249,3,5,8,CST,Morning Event- June 5
7280,7,11,18,CST,Morning Event- June 5
7281,5,5,10,CST,Morning Event- June 5
7290,6,5,11,EST,Morning Event- June 5
7294,6,11,17,CST,Morning Event- June 5
7301,6,6,12,CST,Morning Event- June 5
7324,4,6,10,CST,Morning Event- June 5
7326,4,11,15,CST,Morning Event- June 5
8331,2,16,18,EST,Morning Event- June 5
8930,3,5,8,CST,Morning Event- June 5