Store,Week,Saturday,Sunday,Monday,Tuesday,Wednesday,Thursday,Friday,Total
1,42,1,2,2,1,2,1,2,11
2,42,1,2,2,1,2,1,2,11
3,42,2,1,2,2,1,2,1,11
4,42,1,2,2,1,2,2,2,12
5,42,1,2,2,2,1,2,2,12
7,42,2,1,2,2,1,2,1,11
11,42,2,2,2,2,2,2,2,14
12,42,1,2,2,1,2,1,2,11
14,42,2,1,1,2,1,2,1,10
15,42,2,1,2,2,1,2,2,12
16,42,1,2,1,1,2,1,1,9
17,42,2,1,2,1,2,1,1,10
19,42,2,2,2,2,2,2,2,14
22,42,1,2,1,1,2,1,1,9
26,42,1,2,2,2,2,1,2,12
30,42,1,1,2,1,1,2,1,9
36,42,2,1,2,2,2,1,2,12
37,42,1,2,2,2,1,2,1,11
41,42,2,1,2,2,2,1,2,12
45,42,1,1,2,1,2,2,2,11
46,42,1,2,1,2,1,2,1,10
58,42,2,2,2,3,2,2,2,15
59,42,2,1,2,2,2,1,2,12
61,42,1,2,2,2,2,2,2,13
69,42,1,2,1,2,2,2,1,11
70,42,1,2,1,2,1,2,1,10
75,42,2,1,1,2,2,2,1,11
79,42,2,1,2,1,2,1,1,10
85,42,1,2,2,2,1,2,1,11
91,42,1,1,2,1,1,1,1,8
94,42,2,2,1,2,2,2,1,12
96,42,1,2,1,2,1,2,1,10
98,42,1,1,1,1,1,1,2,8
100,42,2,2,3,2,2,2,2,15
101,42,1,2,1,2,1,2,1,10
103,42,1,2,2,2,2,3,2,14
125,42,2,1,2,2,1,2,1,11
126,42,1,2,1,1,1,2,1,9
129,42,1,2,2,2,1,2,2,12
130,42,1,2,2,2,2,1,2,12
140,42,2,2,2,2,2,2,2,14
144,42,1,2,2,2,2,1,2,12
151,42,1,1,2,2,2,1,2,11
157,42,2,2,2,2,2,2,2,14
168,42,1,2,2,1,2,2,2,12
172,42,2,1,2,1,2,2,1,11
175,42,1,2,1,1,2,1,2,10
177,42,1,1,2,2,1,2,1,10
192,42,2,1,2,2,2,1,2,12
194,42,2,1,2,2,2,2,1,12
195,42,1,2,1,1,1,2,1,9
201,42,1,1,2,1,2,1,2,10
205,42,1,2,1,2,1,2,1,10
219,42,1,2,2,2,1,2,1,11
220,42,1,2,2,2,2,2,2,13
224,42,2,1,2,1,2,1,1,10
228,42,1,2,2,2,2,2,2,13
234,42,1,2,2,1,2,2,2,12
258,42,2,2,1,2,2,2,1,12
261,42,2,2,1,2,2,2,1,12
264,42,2,2,2,2,2,2,2,14
265,42,1,1,2,2,1,2,1,10
272,42,1,2,2,2,2,1,2,12
284,42,2,1,2,2,1,2,2,12
286,42,2,1,2,1,2,2,1,11
287,42,2,1,2,2,2,2,2,13
297,42,2,2,1,2,2,2,2,13
298,42,1,1,2,2,2,1,2,11
299,42,2,2,1,2,2,2,1,12
301,42,1,2,2,2,2,2,2,13
306,42,2,1,1,2,1,1,1,9
308,42,1,1,2,2,1,1,1,9
314,42,1,1,2,1,1,2,1,9
316,42,1,2,1,2,1,2,1,10
319,42,1,2,1,2,1,2,1,10
322,42,1,2,1,2,1,2,2,11
330,42,1,2,1,2,1,2,1,10
355,42,2,1,2,1,2,2,1,11
359,42,2,1,2,2,2,1,2,12
365,42,2,2,2,1,2,2,2,13
371,42,2,1,2,2,2,2,1,12
382,42,1,2,1,1,1,2,1,9
389,42,2,1,2,1,2,1,1,10
395,42,2,2,2,2,2,2,2,14
397,42,2,1,2,2,2,2,2,13
400,42,2,2,2,2,2,2,2,14
407,42,2,2,2,3,2,2,2,15
416,42,2,1,1,2,1,2,1,10
421,42,2,1,2,2,1,2,2,12
423,42,2,1,2,1,2,1,2,11
444,42,1,2,1,2,1,2,1,10
447,42,2,2,2,2,2,2,2,14
452,42,2,2,1,2,2,2,1,12
456,42,2,2,3,2,2,2,2,15
458,42,1,1,2,1,1,2,1,9
459,42,2,2,2,1,2,2,2,13
461,42,2,2,3,2,3,3,3,18
463,42,2,1,1,1,2,1,1,9
465,42,1,1,2,2,1,2,1,10
468,42,1,2,1,1,1,2,1,9
475,42,1,2,2,2,1,2,1,11
479,42,1,1,1,2,1,2,1,9
483,42,1,2,2,2,1,2,1,11
489,42,1,2,2,2,2,2,1,12
491,42,2,1,2,2,2,2,2,13
495,42,2,1,2,1,2,1,2,11
499,42,2,1,2,1,2,1,2,11
500,42,2,2,3,2,2,2,2,15
501,42,2,2,2,2,2,2,2,14
511,42,2,2,2,2,2,2,1,13
512,42,2,2,3,2,3,2,2,16
513,42,2,1,2,1,2,2,1,11
529,42,2,1,2,2,1,2,1,11
533,42,2,1,2,2,1,2,1,11
535,42,2,2,2,2,2,1,2,13
536,42,1,2,2,2,2,1,2,12
537,42,2,2,2,3,2,3,2,16
541,42,2,3,2,2,3,2,2,16
544,42,1,2,2,1,2,1,2,11
546,42,2,1,2,2,1,2,1,11
548,42,2,1,2,1,2,2,1,11
549,42,2,2,3,2,3,2,3,17
551,42,1,2,2,1,2,2,2,12
554,42,2,2,2,3,2,2,3,16
558,42,1,2,1,2,2,2,1,11
560,42,2,2,1,2,2,2,1,12
564,42,2,1,2,1,2,2,1,11
575,42,1,1,2,2,1,1,2,10
576,42,1,2,2,1,2,2,2,12
577,42,2,2,2,2,2,1,2,13
592,42,1,2,1,2,1,2,1,10
594,42,1,2,1,2,1,2,1,10
599,42,2,1,2,2,2,1,2,12
601,42,1,2,1,1,2,1,2,10
602,42,1,1,2,1,1,2,1,9
603,42,2,1,1,2,1,2,1,10
608,42,3,2,3,2,3,2,2,17
611,42,1,2,1,2,1,2,2,11
614,42,2,1,2,1,2,2,1,11
618,42,2,1,2,1,2,2,1,11
622,42,2,1,2,2,2,1,2,12
628,42,2,1,2,1,2,2,1,11
631,42,1,2,2,2,1,2,1,11
649,42,1,2,2,2,1,2,1,11
651,42,2,1,2,2,2,2,1,12
653,42,1,2,2,2,1,2,1,11
661,42,2,2,2,2,2,2,2,14
662,42,2,1,2,2,1,2,1,11
666,42,2,1,2,1,2,1,2,11
668,42,1,2,2,2,2,2,1,12
669,42,2,2,1,2,2,2,1,12
670,42,2,2,2,2,2,3,2,15
671,42,2,1,2,2,2,1,2,12
673,42,1,2,2,2,2,2,2,13
674,42,1,2,2,2,2,2,2,13
677,42,1,2,2,2,2,2,1,12
680,42,2,1,2,2,2,1,2,12
685,42,1,2,2,2,1,2,2,12
690,42,2,1,2,1,2,1,2,11
691,42,1,2,2,1,2,2,2,12
692,42,1,2,2,2,1,2,1,11
697,42,2,2,2,3,2,2,2,15
703,42,1,1,2,2,1,1,2,10
705,42,2,1,2,2,2,2,1,12
708,42,2,1,2,1,2,2,1,11
709,42,2,1,2,2,2,2,2,13
711,42,2,2,1,2,2,2,2,13
715,42,2,2,2,2,2,2,1,13
721,42,2,1,2,2,1,2,1,11
735,42,1,2,1,1,1,2,1,9
743,42,1,2,2,2,1,2,1,11
744,42,2,1,2,2,2,2,2,13
745,42,2,1,2,1,2,1,1,10
752,42,1,2,2,2,1,2,2,12
755,42,1,2,2,2,2,2,2,13
765,42,2,1,2,1,2,1,2,11
766,42,2,2,2,2,2,2,1,13
767,42,1,2,2,2,2,2,2,13
777,42,2,1,2,2,1,2,1,11
780,42,2,1,2,1,2,2,1,11
781,42,1,2,2,1,2,2,2,12
782,42,1,2,1,2,2,2,1,11
787,42,2,1,2,1,2,1,1,10
789,42,2,2,2,2,2,2,1,13
794,42,2,2,1,2,2,2,1,12
803,42,1,1,2,1,1,1,1,8
806,42,2,1,2,1,2,2,1,11
808,42,1,2,1,2,1,2,2,11
810,42,2,1,1,2,1,2,2,11
816,42,2,1,2,2,1,2,2,12
819,42,2,2,2,2,2,2,2,14
821,42,1,2,2,2,2,2,2,13
822,42,1,1,2,2,1,1,2,10
823,42,1,2,1,1,2,1,2,10
835,42,1,1,2,1,1,2,2,10
838,42,1,2,2,1,2,1,2,11
848,42,2,1,2,2,2,1,2,12
850,42,2,2,2,1,2,1,2,12
853,42,2,2,2,1,2,2,1,12
855,42,2,1,2,1,2,1,1,10
861,42,1,2,1,2,2,1,2,11
864,42,2,2,2,2,2,2,2,14
865,42,2,2,2,3,2,2,2,15
866,42,2,1,2,2,2,2,2,13
867,42,2,1,2,1,2,1,2,11
868,42,2,2,2,2,2,2,1,13
874,42,1,2,1,2,1,2,1,10
875,42,1,1,2,1,1,2,1,9
877,42,2,2,1,2,2,2,1,12
880,42,1,2,2,1,2,2,2,12
887,42,1,1,2,1,2,1,1,9
891,42,1,1,1,2,1,2,1,9
894,42,1,2,1,2,2,1,2,11
896,42,1,2,2,2,2,2,2,13
901,42,2,1,2,2,2,2,1,12
906,42,2,2,2,3,2,2,2,15
916,42,2,1,2,2,3,2,2,14
927,42,1,1,2,1,1,2,1,9
928,42,2,2,2,2,2,2,1,13
929,42,1,2,2,2,1,2,1,11
931,42,1,2,2,2,1,2,1,11
936,42,1,2,2,2,1,2,1,11
940,42,2,1,1,2,1,2,1,10
947,42,1,2,2,2,2,1,2,12
963,42,2,1,2,2,1,2,1,11
964,42,3,2,2,3,2,3,2,17
969,42,2,1,2,2,1,2,2,12
973,42,2,1,2,1,2,1,1,10
981,42,1,2,2,2,2,2,2,13
990,42,3,2,3,3,2,3,3,19
994,42,2,1,2,2,2,2,2,13
999,42,1,2,1,2,2,1,2,11
1000,42,2,1,2,2,2,2,2,13
1001,42,2,2,1,2,2,2,1,12
1014,42,2,2,2,2,2,2,1,13
1015,42,2,2,2,2,2,2,2,14
1016,42,2,1,2,2,2,1,2,12
1025,42,1,2,2,2,2,2,2,13
1026,42,2,1,2,2,1,2,1,11
1027,42,1,2,1,1,2,1,2,10
1036,42,2,1,2,2,1,2,2,12
1040,42,2,1,2,2,2,1,2,12
1041,42,1,2,2,1,2,2,2,12
1042,42,1,2,1,1,2,1,2,10
1060,42,2,1,2,1,2,2,1,11
1062,42,2,2,1,2,2,2,1,12
1066,42,2,2,1,2,2,2,2,13
1071,42,2,2,1,2,2,2,1,12
1074,42,1,1,2,1,1,2,1,9
1075,42,2,2,2,2,2,2,1,13
1080,42,2,1,2,2,1,2,1,11
1083,42,2,2,2,2,2,2,1,13
1101,42,1,1,2,1,1,1,2,9
1103,42,1,2,2,2,2,1,2,12
1120,42,1,2,2,2,1,2,1,11
1129,42,1,2,2,1,2,1,1,10
1141,42,2,1,2,2,1,2,2,12
1151,42,1,2,1,1,2,1,2,10
1154,42,1,2,1,1,1,2,1,9
1155,42,1,2,2,2,1,2,2,12
1156,42,1,2,2,1,2,2,2,12
1164,42,2,1,1,1,2,1,1,9
1167,42,2,1,2,2,1,2,1,11
1168,42,2,1,2,2,2,1,2,12
1177,42,1,1,2,1,1,2,1,9
1192,42,1,2,1,1,2,1,2,10
1193,42,2,1,2,1,2,2,1,11
1195,42,1,2,2,1,2,2,2,12
1197,42,2,1,1,2,1,2,1,10
1198,42,2,2,1,2,2,2,1,12
1199,42,2,1,2,1,2,1,1,10
1200,42,2,1,2,1,2,1,2,11
1201,42,2,1,2,2,1,2,2,12
1213,42,2,2,3,3,2,3,2,17
1217,42,1,2,1,1,2,1,2,10
1218,42,2,2,3,2,3,2,2,16
1220,42,2,2,2,2,2,1,2,13
1221,42,2,1,2,2,2,1,2,12
1231,42,2,2,2,2,2,2,2,14
1241,42,1,2,2,2,2,1,2,12
1247,42,2,1,2,2,2,2,2,13
1253,42,2,2,1,2,2,2,1,12
1263,42,1,2,2,2,1,2,1,11
1279,42,2,2,2,1,2,2,2,13
1284,42,2,1,2,1,2,1,2,11
1285,42,2,1,2,2,2,2,1,12
1291,42,2,2,2,2,2,2,1,13
1297,42,2,2,1,2,2,2,1,12
1301,42,1,2,1,2,1,2,1,10
1302,42,1,2,2,1,2,2,1,11
1303,42,2,2,1,2,2,2,2,13
1304,42,2,1,2,1,2,1,1,10
1306,42,1,2,2,2,1,2,1,11
1309,42,1,2,1,1,1,2,1,9
1310,42,2,1,1,2,1,2,1,10
1311,42,2,1,2,1,2,2,1,11
1313,42,2,1,2,1,2,2,1,11
1315,42,1,2,2,1,2,2,2,12
1319,42,1,2,2,2,1,2,1,11
1324,42,2,2,2,2,3,2,2,15
1341,42,1,2,2,2,1,2,1,11
1345,42,1,1,2,1,2,1,2,10
1346,42,2,2,2,2,2,2,1,13
1350,42,2,1,2,2,1,2,1,11
1351,42,1,2,2,2,2,1,2,12
1356,42,1,1,2,1,1,2,1,9
1361,42,2,1,1,2,1,2,1,10
1364,42,1,1,2,2,2,1,2,11
1370,42,1,1,2,1,2,1,2,10
1376,42,1,2,2,2,2,1,2,12
1379,42,2,1,1,2,1,2,1,10
1394,42,2,1,1,2,1,2,1,10
1397,42,2,2,2,2,2,2,1,13
1411,42,1,2,2,2,1,2,2,12
1412,42,1,2,2,2,1,2,1,11
1414,42,1,1,2,1,2,1,1,9
1418,42,1,1,2,2,1,2,1,10
1428,42,1,1,2,2,1,1,2,10
1438,42,1,2,3,2,2,2,2,14
1439,42,2,1,2,2,2,2,1,12
1440,42,2,2,2,2,2,2,2,14
1447,42,1,2,1,2,2,2,1,11
1454,42,1,2,2,1,2,1,2,11
1455,42,2,1,1,2,1,2,1,10
1458,42,2,1,2,2,3,2,2,14
1461,42,1,2,1,2,1,2,1,10
1469,42,1,2,1,1,2,1,2,10
1474,42,1,2,2,2,1,2,1,11
1478,42,1,2,1,2,2,1,2,11
1479,42,1,2,2,2,1,2,1,11
1486,42,2,2,1,1,2,1,2,11
1495,42,1,2,2,2,1,2,2,12
1503,42,2,1,2,2,1,2,1,11
1505,42,1,2,2,2,2,3,2,14
1510,42,2,2,2,2,2,2,1,13
1514,42,2,1,2,2,2,2,2,13
1527,42,2,2,2,2,2,2,2,14
1529,42,2,1,2,2,3,2,2,14
1533,42,1,2,1,2,2,1,2,11
1536,42,2,1,2,2,2,2,1,12
1541,42,2,2,2,2,2,2,1,13
1544,42,2,1,2,2,1,2,2,12
1549,42,2,1,2,2,1,2,2,12
1554,42,2,2,2,2,2,2,2,14
1555,42,2,2,2,2,2,2,1,13
1559,42,2,1,2,1,2,2,1,11
1560,42,2,1,2,2,1,2,1,11
1564,42,2,1,2,3,2,2,2,14
1565,42,2,2,3,2,2,2,3,16
1567,42,2,2,2,2,2,2,1,13
1569,42,1,2,2,2,2,1,2,12
1572,42,1,2,2,1,2,2,2,12
1576,42,1,1,2,1,1,2,1,9
1577,42,2,1,1,2,1,1,1,9
1583,42,2,1,2,1,2,1,2,11
1584,42,1,2,2,2,1,2,1,11
1588,42,2,1,2,2,2,1,2,12
1591,42,2,2,2,2,2,2,1,13
1595,42,1,2,1,1,2,1,2,10
1600,42,1,2,1,2,1,2,1,10
1604,42,1,2,2,3,2,2,2,14
1606,42,2,1,2,1,2,2,1,11
1607,42,2,2,1,2,2,2,1,12
1612,42,2,2,2,2,3,2,2,15
1614,42,2,1,1,2,1,1,1,9
1623,42,2,2,1,2,2,2,1,12
1624,42,2,2,1,2,2,2,1,12
1626,42,2,1,2,1,2,1,2,11
1632,42,1,2,1,2,1,2,1,10
1634,42,2,1,1,2,1,2,1,10
1636,42,2,2,2,3,2,2,2,15
1645,42,2,2,2,2,2,2,2,14
1646,42,1,2,1,1,1,2,1,9
1655,42,2,1,1,2,1,2,1,10
1659,42,2,1,2,1,2,1,2,11
1660,42,1,2,2,2,1,2,1,11
1664,42,2,1,2,1,2,1,2,11
1674,42,2,2,2,2,2,2,2,14
1677,42,1,2,2,2,2,2,2,13
1680,42,2,1,2,2,2,1,2,12
1686,42,1,2,2,1,2,1,2,11
1689,42,1,1,2,2,2,1,2,11
1694,42,1,2,1,2,1,2,1,10
1699,42,1,2,2,2,1,2,1,11
1700,42,2,1,2,1,2,1,1,10
1703,42,2,2,1,2,2,2,2,13
1708,42,1,2,1,2,1,2,1,10
1710,42,2,1,2,2,1,2,1,11
1733,42,1,1,2,1,1,2,1,9
1739,42,2,1,2,2,3,2,2,14
1741,42,2,2,1,2,2,2,1,12
1744,42,2,1,2,1,2,2,1,11
1746,42,2,1,2,1,2,2,1,11
1747,42,2,1,2,2,2,2,1,12
1759,42,2,1,2,2,2,2,2,13
1789,42,2,1,2,2,2,2,1,12
1790,42,2,1,2,1,2,1,2,11
1805,42,1,2,1,2,2,1,2,11
1812,42,1,2,2,1,2,2,2,12
1815,42,2,1,2,3,2,2,2,14
1825,42,2,2,1,2,2,2,1,12
1826,42,2,2,1,2,2,2,1,12
1832,42,2,1,2,2,1,2,1,11
1836,42,2,1,2,2,1,2,1,11
1837,42,1,2,1,2,2,1,2,11
1840,42,1,2,1,1,2,1,1,9
1846,42,2,1,1,2,1,2,1,10
1847,42,2,1,2,2,2,1,2,12
1852,42,2,2,2,2,2,2,2,14
1853,42,2,2,2,1,2,2,2,13
1859,42,2,3,2,3,2,3,3,18
1862,42,2,2,2,2,2,3,2,15
1872,42,1,1,2,2,1,1,2,10
1877,42,2,1,2,2,1,2,1,11
1886,42,2,2,2,2,2,2,1,13
1887,42,1,2,1,1,2,1,2,10
1890,42,2,1,2,2,1,2,2,12
1891,42,2,1,2,1,2,2,1,11
1894,42,1,2,1,2,1,2,2,11
1899,42,1,2,2,2,2,2,2,13
1900,42,1,1,1,2,1,1,2,9
1902,42,1,2,3,2,2,2,2,14
1903,42,1,2,1,2,1,2,1,10
1904,42,1,2,1,2,1,2,1,10
1906,42,1,1,1,1,1,2,1,8
1914,42,1,1,2,1,2,1,2,10
1917,42,1,1,2,1,2,1,1,9
1922,42,1,2,1,1,2,1,2,10
1924,42,2,2,2,2,2,2,1,13
1929,42,2,1,2,2,1,2,1,11
1930,42,2,1,1,2,1,1,1,9
1941,42,1,1,1,2,1,1,2,9
1943,42,1,2,2,2,1,2,1,11
1946,42,1,2,1,1,2,1,2,10
1951,42,2,1,2,2,2,2,1,12
1956,42,2,1,2,2,2,2,2,13
1963,42,1,1,2,1,1,1,1,8
1971,42,2,1,2,2,2,2,1,12
1973,42,1,2,2,1,2,2,2,12
1976,42,2,1,2,2,1,2,2,12
1978,42,1,2,1,2,1,2,1,10
1980,42,2,1,2,1,2,1,1,10
1981,42,2,2,2,2,2,2,2,14
1987,42,2,1,2,1,2,2,1,11
1995,42,2,2,1,2,2,2,1,12
1999,42,1,2,1,1,1,2,1,9
2010,42,1,1,2,1,1,2,1,9
2012,42,1,2,1,1,2,1,2,10
2013,42,2,2,2,2,2,2,2,14
2021,42,2,2,2,2,2,2,1,13
2022,42,1,2,1,2,1,2,1,10
2024,42,1,1,2,1,1,2,1,9
2025,42,2,1,2,2,1,2,1,11
2027,42,2,2,3,2,2,2,2,15
2028,42,1,2,2,1,2,2,2,12
2032,42,2,2,2,2,1,2,1,12
2036,42,2,2,2,2,2,2,2,14
2038,42,1,2,2,2,1,2,1,11
2050,42,1,2,1,1,1,2,1,9
2051,42,2,2,2,2,2,3,2,15
2059,42,1,2,2,2,2,2,2,13
2063,42,2,1,2,2,1,2,1,11
2064,42,2,1,2,2,1,2,1,11
2066,42,1,1,2,1,2,1,2,10
2073,42,2,1,2,2,2,2,2,13
2077,42,1,2,1,1,2,1,2,10
2078,42,1,2,2,2,2,2,2,13
2082,42,1,1,2,1,2,1,2,10
2087,42,1,2,2,1,2,1,2,11
2091,42,2,3,3,2,3,3,3,19
2101,42,2,2,2,2,2,1,2,13
2107,42,2,1,2,1,2,1,2,11
2111,42,2,1,2,1,2,1,1,10
2113,42,1,2,2,2,1,2,1,11
2119,42,2,1,2,1,2,1,1,10
2123,42,2,2,1,2,2,2,2,13
2129,42,1,1,2,1,2,1,1,9
2133,42,2,1,2,2,2,2,1,12
2141,42,2,2,3,2,2,3,2,16
2147,42,1,1,2,1,1,1,2,9
2150,42,2,1,2,2,2,2,2,13
2154,42,2,1,2,2,2,2,1,12
2157,42,2,1,2,2,2,2,1,12
2169,42,2,2,1,2,2,2,1,12
2176,42,2,1,2,1,2,1,1,10
2177,42,1,2,1,1,2,1,2,10
2181,42,1,1,2,2,1,2,1,10
2184,42,1,2,1,1,1,2,1,9
2193,42,2,1,2,2,1,2,1,11
2194,42,2,1,2,2,2,2,2,13
2197,42,2,2,1,2,2,2,1,12
2199,42,2,1,2,2,2,1,2,12
2201,42,2,2,2,3,2,3,2,16
2208,42,1,2,2,2,1,2,2,12
2209,42,1,2,2,2,1,2,2,12
2210,42,2,2,2,2,2,2,2,14
2211,42,2,1,1,2,1,2,1,10
2213,42,2,1,1,2,1,2,1,10
2221,42,2,1,2,2,2,2,1,12
2225,42,2,2,1,2,2,2,2,13
2227,42,1,2,1,1,1,2,1,9
2233,42,2,2,1,2,2,2,1,12
2239,42,2,2,2,3,2,2,2,15
2242,42,1,2,1,1,2,1,2,10
2245,42,2,1,2,1,2,1,1,10
2249,42,2,3,2,2,3,2,2,16
2251,42,2,1,1,1,2,1,1,9
2252,42,1,2,2,2,2,1,2,12
2255,42,1,2,2,1,2,1,2,11
2257,42,1,1,2,1,2,1,2,10
2264,42,1,2,1,1,1,2,1,9
2269,42,2,2,2,3,2,1,2,14
2271,42,1,2,1,1,2,1,1,9
2273,42,1,2,1,1,2,1,2,10
2274,42,2,2,2,2,1,2,1,12
2277,42,1,2,1,1,1,2,1,9
2282,42,2,2,1,2,2,2,1,12
2285,42,2,2,2,2,2,2,2,14
2286,42,2,1,2,1,2,2,1,11
2291,42,1,2,1,2,2,1,2,11
2299,42,1,1,2,2,1,1,2,10
2300,42,2,1,2,2,2,1,2,12
2306,42,2,1,2,1,2,2,1,11
2307,42,1,1,2,1,1,2,1,9
2310,42,2,1,2,1,2,1,2,11
2313,42,1,2,1,1,2,1,1,9
2322,42,1,1,2,2,1,2,1,10
2331,42,2,1,2,2,2,2,2,13
2336,42,2,1,1,2,1,2,1,10
2338,42,1,1,2,1,1,2,1,9
2351,42,1,2,1,1,2,1,2,10
2352,42,2,1,2,2,1,2,2,12
2354,42,2,1,1,1,2,1,1,9
2357,42,2,2,2,2,2,3,2,15
2362,42,1,2,2,2,2,2,1,12
2365,42,2,1,1,2,1,2,1,10
2371,42,1,2,2,2,1,2,2,12
2386,42,1,2,2,1,2,1,2,11
2402,42,2,1,2,1,2,1,2,11
2412,42,1,1,2,2,1,1,2,10
2420,42,1,1,2,1,2,2,1,10
2428,42,1,2,1,1,1,2,1,9
2444,42,1,2,1,2,1,2,1,10
2475,42,2,1,2,1,2,1,1,10
2479,42,2,1,2,2,2,2,1,12
2480,42,2,1,2,1,2,1,2,11
2483,42,2,1,1,2,1,2,1,10
2504,42,2,1,2,2,1,2,2,12
2508,42,2,1,2,1,2,1,2,11
2516,42,2,2,2,2,2,2,2,14
2529,42,2,2,1,2,2,2,1,12
2533,42,1,2,2,2,1,2,1,11
2536,42,2,1,1,1,2,1,1,9
2541,42,2,2,1,2,2,2,1,12
2545,42,2,1,2,2,1,2,1,11
2549,42,2,2,3,2,3,3,2,17
2554,42,1,2,1,2,2,1,2,11
2559,42,2,1,2,1,2,1,1,10
2581,42,1,2,2,2,2,2,2,13
2585,42,2,1,2,2,1,2,2,12
2586,42,1,2,2,2,1,2,2,12
2587,42,2,2,2,2,2,2,2,14
2588,42,2,1,2,2,1,2,2,12
2592,42,1,2,2,1,2,1,2,11
2593,42,2,1,3,2,2,2,2,14
2595,42,1,1,2,2,2,1,2,11
2598,42,1,2,1,1,2,1,1,9
2605,42,1,2,2,1,2,2,2,12
2609,42,2,1,2,1,2,1,2,11
2610,42,1,2,2,1,2,2,2,12
2612,42,2,1,2,3,2,3,2,15
2618,42,1,1,2,2,1,1,1,9
2628,42,2,1,2,2,2,1,2,12
2638,42,1,2,1,1,2,1,2,10
2641,42,2,1,2,1,2,2,1,11
2656,42,1,2,1,1,2,1,1,9
2663,42,2,1,2,1,2,1,1,10
2665,42,2,2,2,2,2,2,1,13
2678,42,1,2,2,2,1,2,1,11
2679,42,2,1,1,1,2,1,1,9
2682,42,1,1,1,2,1,1,2,9
2690,42,1,1,2,2,1,2,1,10
2692,42,2,1,2,1,2,1,2,11
2695,42,2,2,2,3,2,2,2,15
2697,42,2,2,1,2,2,2,1,12
2706,42,2,2,1,2,2,2,1,12
2708,42,2,2,3,2,2,2,2,15
2713,42,1,2,1,2,1,2,1,10
2715,42,2,2,2,2,2,2,2,14
2720,42,2,1,2,2,2,2,2,13
2723,42,1,1,1,1,1,2,1,8
2726,42,2,2,2,2,2,2,3,15
2732,42,2,1,2,1,2,1,1,10
2755,42,2,1,2,2,2,2,2,13
2763,42,1,2,2,2,2,1,2,12
2766,42,1,1,2,1,2,1,2,10
2767,42,1,1,2,2,1,2,1,10
2768,42,2,1,2,1,2,1,1,10
2777,42,2,1,2,2,1,2,2,12
2780,42,1,2,2,1,2,2,2,12
2781,42,1,2,2,2,1,2,1,11
2788,42,2,1,1,2,1,2,1,10
2789,42,1,2,1,2,1,2,2,11
2796,42,2,1,2,2,2,1,2,12
2803,42,1,2,1,1,2,1,2,10
2804,42,1,2,1,1,2,1,2,10
2806,42,2,2,2,1,2,2,2,13
2811,42,1,2,1,1,2,1,2,10
2812,42,1,2,1,2,1,2,1,10
2814,42,2,2,3,2,3,2,2,16
2818,42,1,2,2,2,1,2,1,11
2830,42,2,1,1,2,1,2,1,10
2836,42,2,1,1,2,1,2,1,10
2838,42,2,2,2,2,2,2,1,13
2842,42,1,1,2,1,1,1,2,9
2843,42,2,1,1,2,1,2,1,10
2844,42,2,1,2,2,2,2,2,13
2847,42,2,2,2,2,2,2,1,13
2853,42,1,1,2,2,1,2,1,10
2854,42,2,2,1,2,2,2,1,12
2855,42,1,2,1,2,1,2,1,10
2857,42,2,2,2,3,2,2,2,15
2859,42,2,1,2,1,2,2,1,11
2862,42,1,2,1,1,2,1,2,10
2864,42,1,2,2,2,2,1,2,12
2874,42,1,2,2,1,2,2,2,12
2884,42,1,2,2,2,2,2,2,13
2886,42,2,2,2,3,2,2,3,16
2889,42,2,1,1,2,1,2,1,10
2891,42,2,2,2,3,2,3,2,16
2910,42,1,2,1,2,2,2,1,11
2914,42,2,2,2,2,2,2,2,14
2921,42,1,1,2,2,1,2,1,10
2922,42,2,1,2,1,2,2,1,11
2924,42,2,1,2,2,2,1,2,12
2939,42,2,1,2,1,2,1,1,10
2952,42,1,2,2,2,1,2,1,11
2953,42,1,2,2,2,1,2,1,11
2954,42,2,1,2,2,2,2,1,12
2958,42,2,1,2,1,2,1,2,11
2959,42,1,2,2,2,1,2,2,12
2965,42,2,1,1,1,2,1,1,9
2980,42,2,1,2,1,2,1,2,11
2985,42,2,2,2,2,2,2,1,13
2987,42,2,1,2,2,1,2,1,11
2988,42,1,1,2,1,1,2,1,9
2991,42,2,1,2,2,1,2,1,11
2994,42,1,2,1,1,2,1,2,10
3017,42,1,2,1,2,1,2,1,10
3035,42,1,1,3,2,2,3,2,14
3056,42,1,2,2,2,1,2,1,11
3057,42,1,1,2,1,1,2,1,9
3058,42,1,2,1,2,2,1,2,11
3093,42,2,1,1,2,1,1,1,9
3106,42,2,2,1,2,2,2,1,12
3114,42,2,2,1,2,2,2,1,12
3136,42,2,2,2,2,2,2,2,14
3151,42,1,2,1,1,2,1,1,9
3159,42,2,2,2,3,2,2,3,16
3163,42,1,2,1,2,2,1,2,11
3169,42,1,1,2,1,1,2,1,9
3170,42,1,1,2,1,1,2,1,9
3180,42,2,2,3,2,2,3,2,16
3205,42,2,1,2,1,2,1,1,10
3206,42,2,1,2,1,2,2,1,11
3208,42,1,2,1,1,2,1,1,9
3209,42,1,2,1,2,1,2,1,10
3213,42,1,1,2,2,1,1,2,10
3214,42,1,2,1,2,1,2,1,10
3223,42,2,2,1,2,2,2,1,12
3224,42,2,1,2,1,2,2,1,11
3226,42,2,1,2,1,2,1,1,10
3232,42,1,2,2,2,1,2,1,11
3237,42,2,2,1,2,2,2,1,12
3241,42,2,1,1,2,1,2,1,10
3243,42,1,2,1,2,1,2,1,10
3248,42,1,2,1,1,1,2,1,9
3251,42,2,1,2,1,2,1,1,10
3259,42,1,2,2,2,1,2,1,11
3262,42,2,2,2,2,2,2,1,13
3279,42,2,1,2,1,2,1,2,11
3280,42,1,2,1,2,1,2,1,10
3282,42,1,2,2,2,1,2,1,11
3283,42,2,2,1,2,2,2,2,13
3284,42,1,1,2,1,2,1,1,9
3292,42,1,2,1,2,1,2,2,11
3308,42,2,2,1,2,2,2,1,12
3320,42,2,2,3,2,2,2,2,15
3331,42,2,2,1,2,2,2,1,12
3332,42,2,1,2,1,2,2,1,11
3350,42,2,1,2,2,2,1,2,12
3351,42,2,1,2,2,2,2,2,13
3360,42,2,1,1,2,1,2,1,10
3363,42,1,1,2,1,2,1,2,10
3366,42,1,2,1,1,1,2,1,9
3379,42,2,1,1,2,1,1,1,9
3382,42,1,2,1,1,2,1,2,10
3387,42,2,2,2,2,2,2,2,14
3390,42,1,1,2,1,2,1,2,10
3402,42,2,1,2,1,2,1,1,10
3403,42,2,2,2,1,2,2,2,13
3407,42,2,2,1,2,2,2,2,13
3417,42,1,2,1,1,1,2,1,9
3418,42,2,3,3,3,2,3,3,19
3428,42,2,1,1,1,2,1,1,9
3431,42,1,2,1,1,2,1,2,10
3433,42,2,1,2,1,2,1,1,10
3435,42,2,1,2,2,1,2,1,11
3436,42,1,1,2,2,1,2,1,10
3454,42,2,1,1,1,2,1,1,9
3455,42,2,1,2,1,2,1,1,10
3461,42,2,1,2,1,2,1,1,10
3464,42,2,2,1,2,2,2,1,12
3465,42,1,2,2,1,2,2,2,12
3473,42,2,1,2,2,2,2,2,13
3476,42,2,1,2,1,2,1,1,10
3477,42,1,1,1,2,1,2,1,9
3486,42,2,2,2,2,2,2,1,13
3492,42,1,2,2,1,2,2,2,12
3495,42,2,1,2,2,2,2,2,13
3500,42,1,2,2,2,2,2,2,13
3515,42,1,2,1,2,1,2,1,10
3516,42,2,2,2,2,2,2,2,14
3518,42,2,2,3,2,2,2,2,15
3520,42,3,2,2,3,2,3,2,17
3522,42,2,2,2,2,2,2,2,14
3529,42,2,1,1,2,1,2,1,10
3533,42,2,1,2,2,1,2,2,12
3538,42,2,1,2,1,2,1,1,10
3564,42,2,1,2,2,2,2,1,12
3567,42,2,1,2,2,2,2,2,13
3568,42,2,1,2,2,2,1,2,12
3569,42,2,2,1,2,2,2,2,13
3572,42,1,2,2,2,1,2,1,11
3584,42,2,1,2,1,2,2,1,11
3585,42,1,1,2,1,2,1,1,9
3589,42,1,1,2,2,1,2,1,10
3596,42,2,1,1,1,2,1,1,9
3616,42,1,2,1,1,1,2,1,9
3620,42,1,2,1,2,1,2,1,10
3623,42,1,2,1,2,1,2,1,10
3640,42,1,1,1,2,1,2,1,9
3641,42,1,2,1,1,2,1,1,9
3645,42,2,2,1,2,2,2,2,13
3648,42,2,1,2,2,2,2,1,12
3652,42,1,1,2,2,1,2,1,10
3658,42,2,1,2,1,2,2,1,11
3659,42,2,1,1,2,1,2,1,10
3720,42,2,1,2,2,1,2,1,11
3722,42,2,1,2,2,2,2,1,12
3726,42,2,1,2,1,2,2,1,11
3728,42,1,1,2,2,1,1,2,10
3730,42,2,1,2,1,2,1,1,10
3731,42,1,2,1,2,1,2,2,11
3738,42,1,1,2,2,1,2,1,10
3739,42,2,1,2,1,2,1,1,10
3748,42,2,1,2,1,2,1,1,10
3751,42,2,1,2,1,2,2,2,12
3754,42,1,1,2,1,1,1,2,9
3762,42,2,1,2,2,1,2,1,11
3763,42,2,2,2,2,2,2,2,14
3771,42,1,2,2,2,2,2,2,13
3786,42,2,1,2,1,2,1,2,11
3792,42,2,2,1,2,2,2,1,12
3796,42,2,2,2,2,2,1,2,13
3833,42,2,1,2,2,2,1,2,12
3835,42,1,2,1,2,2,2,1,11
3838,42,2,1,2,1,2,2,1,11
3847,42,1,1,1,1,1,2,1,8
3860,42,1,1,2,1,1,2,1,9
3874,42,2,1,2,1,2,1,2,11
3886,42,1,2,2,2,1,2,2,12
3888,42,2,2,2,2,2,2,2,14
3894,42,1,2,2,1,2,1,2,11
3896,42,1,2,1,1,2,1,1,9
3897,42,2,2,2,2,2,3,2,15
4055,42,2,1,2,1,2,2,1,11
4064,42,2,1,1,2,1,2,1,10
4068,42,1,2,1,1,1,2,1,9
4112,42,2,1,2,2,1,2,2,12
4115,42,1,2,1,2,1,2,1,10
4118,42,2,1,1,2,1,2,1,10
4129,42,1,1,2,2,1,2,2,11
4130,42,2,1,2,1,2,1,2,11
4153,42,1,1,2,1,1,2,1,9
4195,42,1,2,1,1,2,1,2,10
4201,42,2,1,1,2,1,2,1,10
4219,42,1,2,2,2,1,2,1,11
4239,42,1,2,1,1,1,2,1,9
4240,42,1,1,2,1,2,1,2,10
4243,42,2,1,2,1,2,2,1,11
4255,42,1,2,2,2,1,2,2,12
4260,42,1,2,2,2,1,2,1,11
4262,42,2,2,1,2,2,2,1,12
4272,42,2,1,1,2,1,1,1,9
4274,42,2,2,1,2,2,2,1,12
4285,42,2,1,2,2,2,2,2,13
4295,42,2,1,1,1,2,1,1,9
4299,42,2,1,2,2,2,2,2,13
4321,42,1,2,1,2,1,2,1,10
4325,42,2,1,2,2,2,1,2,12
4330,42,1,1,2,1,1,1,2,9
4334,42,1,2,1,2,2,1,2,11
4337,42,2,1,2,2,1,2,1,11
4340,42,2,1,2,2,2,2,2,13
4356,42,2,1,2,2,2,2,1,12
4358,42,1,2,1,2,1,2,1,10
4378,42,1,1,1,2,1,1,1,8
4392,42,1,2,1,2,1,2,2,11
4404,42,1,1,2,1,1,2,1,9
4416,42,1,1,2,2,1,1,2,10
4423,42,2,2,2,2,2,2,1,13
4424,42,2,1,2,2,2,1,2,12
4430,42,2,2,1,2,2,2,1,12
4438,42,2,1,2,2,2,3,2,14
4444,42,2,1,1,2,1,2,1,10
4451,42,1,2,2,1,2,2,2,12
4460,42,1,2,1,2,1,2,1,10
4482,42,1,2,1,2,1,2,1,10
4487,42,2,1,2,2,1,2,2,12
4526,42,2,1,2,1,2,2,1,11
4531,42,1,1,2,1,1,2,1,9
4553,42,2,1,2,2,2,2,2,13
4581,42,1,1,2,1,1,1,1,8
4601,42,2,2,1,2,2,2,1,12
4627,42,2,2,1,2,2,2,1,12
4631,42,1,2,2,2,1,2,1,11
4660,42,2,1,1,1,2,1,1,9
4678,42,1,1,1,2,1,1,1,8
5023,42,2,2,2,1,2,2,2,13
5031,42,1,2,2,1,2,2,2,12
5034,42,2,1,2,1,2,2,1,11
5045,42,2,1,2,1,2,1,2,11
5054,42,2,1,1,2,1,2,1,10
5055,42,2,1,2,1,2,1,2,11
5070,42,1,2,2,1,2,2,2,12
5072,42,2,2,2,2,3,2,2,15
5087,42,2,2,2,2,2,2,2,14
5091,42,2,1,2,2,2,2,1,12
5095,42,2,2,2,2,2,2,1,13
5096,42,2,1,2,1,2,1,1,10
5099,42,2,2,2,2,2,2,2,14
5101,42,2,1,2,1,2,1,1,10
5105,42,2,1,1,2,1,2,1,10
5123,42,1,2,2,2,2,2,2,13
5124,42,1,2,1,2,1,2,1,10
5130,42,2,2,2,2,2,2,1,13
5140,42,1,2,1,2,1,2,1,10
5145,42,1,2,2,2,1,2,1,11
5147,42,2,2,1,2,2,2,1,12
5151,42,2,1,2,1,2,1,1,10
5154,42,2,2,2,3,2,3,2,17
5155,42,1,1,2,1,2,2,2,11
5156,42,2,2,2,1,2,2,2,13
5160,42,2,1,2,1,2,1,1,10
5167,42,1,1,2,2,1,2,1,10
5173,42,1,2,1,2,1,2,2,11
5175,42,1,2,1,2,1,2,1,10
5185,42,2,2,2,1,2,1,2,12
5189,42,1,2,1,2,1,2,2,11
5193,42,2,1,1,2,1,2,1,10
5196,42,1,2,1,1,1,2,1,9
5203,42,1,1,2,1,1,2,1,9
5216,42,2,1,2,2,1,2,1,11
5233,42,1,1,2,2,1,2,1,10
5234,42,1,2,2,2,1,2,1,11
5235,42,2,1,1,2,1,1,1,9
5245,42,1,2,2,2,2,2,2,13
5252,42,2,1,2,1,2,2,1,11
5253,42,1,2,1,1,1,2,1,9
5261,42,2,1,1,2,1,1,1,9
5275,42,2,2,1,2,2,2,2,13
5278,42,2,2,2,3,2,2,2,15
5281,42,2,1,2,1,2,2,1,11
5292,42,2,1,1,2,1,2,1,10
5299,42,2,2,2,2,2,2,2,14
5301,42,2,1,1,2,1,2,1,10
5305,42,2,1,2,2,2,2,2,13
5316,42,1,2,2,2,2,1,2,12
5319,42,1,1,2,2,1,2,1,10
5325,42,1,1,1,1,1,1,2,8
5326,42,1,2,2,2,1,2,2,12
5330,42,2,1,2,2,1,2,1,11
5331,42,1,2,1,2,2,1,2,11
5334,42,2,2,2,2,2,2,2,14
5337,42,2,1,2,2,2,2,2,13
5338,42,2,1,2,2,1,2,2,12
5342,42,1,2,2,2,2,1,2,12
5343,42,2,2,2,2,2,3,2,15
5347,42,1,2,1,2,1,2,1,10
5359,42,2,1,2,2,1,2,1,11
5361,42,1,2,1,2,2,1,2,11
5369,42,2,2,1,2,2,2,1,12
5391,42,2,1,2,1,2,1,2,11
5394,42,2,1,2,2,2,2,1,12
5403,42,1,1,2,1,1,1,1,8
5416,42,2,1,2,1,2,1,2,11
5420,42,2,1,2,1,2,2,1,11
5425,42,2,2,1,2,2,2,2,13
5428,42,2,1,1,2,1,2,1,10
5429,42,2,2,1,2,2,2,1,12
5430,42,2,1,2,2,2,2,2,13
5441,42,1,1,2,1,1,2,1,9
5443,42,1,2,2,2,1,2,1,11
5447,42,3,2,3,3,3,3,3,20
5449,42,2,1,1,2,1,1,1,9
5485,42,1,2,1,2,1,2,2,11
5488,42,2,2,2,2,2,2,1,13
5491,42,1,1,2,2,1,2,1,10
5494,42,2,1,2,2,2,1,2,12
5626,42,1,2,2,2,1,2,2,12
5671,42,1,2,1,2,1,2,1,10
5686,42,2,2,2,3,2,2,3,16
5707,42,2,1,1,2,1,2,1,10
5717,42,2,2,2,2,2,2,2,14
5763,42,1,1,2,1,1,1,1,8
5814,42,1,2,1,1,1,2,1,9
5841,42,2,1,1,2,1,1,1,9
5842,42,1,2,1,2,1,2,1,10
5844,42,1,1,2,2,1,2,1,10
5867,42,2,1,2,1,2,1,2,11
5883,42,1,2,1,2,1,2,2,11
5947,42,2,1,2,1,2,1,2,11
5959,42,2,1,2,1,2,2,1,11
6397,42,1,2,1,2,1,2,2,11
6579,42,2,1,2,2,2,2,1,12
6789,42,2,1,1,1,1,2,1,9
6807,42,1,1,2,2,1,2,1,10
6879,42,2,1,2,1,2,2,1,11
6898,42,2,1,2,2,1,2,1,11
6963,42,1,2,1,2,2,1,2,11
7178,42,1,2,1,1,2,1,2,10
7185,42,2,1,1,1,2,1,1,9
7301,42,2,1,2,2,1,2,1,11
7326,42,1,2,1,1,2,1,2,10
1,43,2,1,2,2,2,1,2,12
3,43,1,2,2,1,2,2,2,12
5,43,1,2,1,1,1,2,1,9
7,43,1,1,2,1,1,1,2,9
10,43,2,1,2,1,2,2,1,11
11,43,2,1,2,1,1,2,1,10
13,43,2,2,1,2,2,2,2,13
14,43,1,1,1,2,1,1,2,9
17,43,2,1,2,1,2,2,1,11
19,43,2,2,1,2,2,2,1,12
26,43,2,2,2,2,1,2,2,13
30,43,1,2,1,2,1,2,1,10
36,43,2,1,2,2,1,2,2,12
37,43,2,2,2,1,2,2,1,12
45,43,2,2,1,2,2,2,1,12
47,43,1,1,1,1,2,1,1,8
52,43,1,2,2,1,2,2,2,12
58,43,1,2,2,1,2,2,2,12
61,43,1,1,2,1,1,1,2,9
65,43,2,2,1,2,2,1,2,12
66,43,1,1,2,1,1,1,2,9
67,43,1,1,2,1,1,1,2,9
69,43,2,2,2,2,2,2,2,14
70,43,2,2,1,2,1,2,1,11
72,43,2,2,2,1,2,2,2,13
75,43,2,1,2,1,1,2,1,10
76,43,2,2,1,2,2,2,1,12
77,43,1,1,1,2,1,1,1,8
80,43,2,2,1,2,1,2,1,11
85,43,2,2,1,2,1,2,1,11
86,43,1,1,2,1,1,1,1,8
91,43,1,2,1,1,2,1,1,9
94,43,1,2,1,1,1,2,1,9
95,43,2,2,2,2,2,2,2,14
96,43,1,2,1,2,1,2,1,10
98,43,1,1,1,1,1,1,2,8
100,43,2,2,2,2,1,2,2,13
101,43,2,1,2,2,1,2,2,12
103,43,1,1,1,1,1,1,2,8
108,43,1,2,2,2,2,2,2,13
110,43,1,2,1,2,2,1,2,11
114,43,1,1,1,2,1,1,1,8
121,43,1,2,1,1,1,2,1,9
124,43,1,2,1,1,1,2,1,9
125,43,1,2,2,2,1,2,2,12
126,43,1,2,2,1,2,2,2,12
128,43,1,1,1,1,2,1,1,8
130,43,2,1,1,1,2,1,1,9
137,43,2,1,1,2,1,2,1,10
140,43,2,1,2,2,2,1,2,12
141,43,1,2,1,1,2,1,1,9
157,43,2,1,2,1,1,2,1,10
160,43,2,1,1,1,1,1,1,8
164,43,2,1,2,1,2,2,1,11
168,43,2,1,2,2,2,1,2,12
172,43,1,2,1,1,2,1,2,10
174,43,2,1,2,1,2,2,1,11
175,43,2,2,1,2,1,2,1,11
179,43,1,2,2,1,2,2,2,12
182,43,2,1,1,2,1,2,1,10
184,43,2,2,1,2,2,2,1,12
185,43,2,1,1,1,2,1,1,9
186,43,2,1,2,1,2,1,2,11
195,43,2,1,2,2,1,2,2,12
196,43,1,2,2,2,2,2,2,13
199,43,1,2,2,1,2,1,2,11
200,43,2,2,3,2,2,3,2,16
205,43,2,1,2,2,1,2,2,12
219,43,1,2,1,1,2,1,2,10
224,43,2,2,2,2,3,2,2,15
234,43,2,1,1,2,1,1,1,9
239,43,2,2,2,2,2,1,2,13
258,43,2,1,2,2,2,1,2,12
261,43,2,2,3,2,2,2,3,16
262,43,2,2,2,1,2,2,1,12
264,43,2,2,2,2,2,2,2,14
266,43,2,2,1,2,2,2,2,13
273,43,2,2,1,2,1,2,1,11
286,43,1,2,2,2,1,2,2,12
287,43,1,1,2,1,1,1,2,9
292,43,2,2,2,2,2,2,2,14
299,43,1,2,2,2,2,2,2,13
301,43,2,1,2,1,1,2,1,10
305,43,2,2,2,2,2,2,2,14
306,43,2,1,2,2,2,2,2,13
309,43,1,1,2,2,2,2,1,11
314,43,2,2,1,2,2,2,1,12
315,43,2,1,2,1,2,2,1,11
316,43,1,2,1,1,2,1,2,10
319,43,2,1,2,2,1,2,1,11
340,43,1,1,2,1,1,1,2,9
351,43,2,2,2,1,2,2,1,12
355,43,2,2,2,2,2,2,1,13
359,43,2,1,2,1,1,2,1,10
365,43,2,1,2,2,2,1,2,12
371,43,2,1,2,1,2,2,1,11
375,43,2,2,2,2,2,2,1,13
382,43,2,1,2,2,1,2,1,11
384,43,2,2,1,2,2,2,1,12
388,43,2,2,2,2,1,2,2,13
389,43,1,2,2,1,2,2,1,11
392,43,2,2,1,2,2,2,2,13
395,43,2,2,1,2,1,2,1,11
396,43,2,1,1,2,1,2,1,10
397,43,2,2,2,1,2,2,1,12
400,43,2,1,2,1,2,2,1,11
407,43,1,2,2,1,2,2,2,12
410,43,1,2,2,2,1,2,2,12
413,43,2,2,1,2,1,2,1,11
416,43,2,2,2,2,3,2,2,15
421,43,2,2,1,2,1,2,1,11
423,43,2,1,2,2,1,2,1,11
424,43,2,2,2,1,2,2,2,13
428,43,1,1,1,1,2,1,1,8
429,43,2,1,2,2,2,2,2,13
440,43,1,2,2,1,2,1,2,11
444,43,2,2,1,2,2,2,2,13
447,43,2,1,2,2,2,1,2,12
451,43,2,2,2,1,2,2,2,13
452,43,2,2,2,2,2,2,2,14
456,43,1,1,2,1,2,1,2,10
458,43,2,2,2,2,2,2,2,14
459,43,1,1,2,1,1,2,1,9
461,43,2,2,1,2,1,2,1,11
463,43,2,2,1,2,2,1,2,12
465,43,2,2,2,2,1,2,2,13
468,43,2,1,2,1,2,2,1,11
475,43,2,2,1,2,2,1,2,12
479,43,2,2,2,2,2,2,1,13
483,43,2,2,1,2,2,2,1,12
484,43,2,1,2,2,2,2,2,13
489,43,1,2,1,1,2,1,2,10
490,43,2,2,1,2,2,2,1,12
491,43,2,2,2,2,2,2,2,14
495,43,2,2,2,2,2,2,1,13
499,43,1,2,1,2,1,2,2,11
500,43,2,1,2,1,1,2,1,10
501,43,1,2,1,1,1,2,1,9
502,43,2,2,2,3,2,2,2,15
508,43,2,2,3,2,2,2,3,16
511,43,2,2,1,2,2,2,1,12
512,43,2,1,2,2,1,2,2,12
513,43,2,2,1,2,2,1,2,12
514,43,1,2,1,1,1,2,1,9
515,43,1,2,1,1,1,2,1,9
518,43,2,1,1,2,1,1,1,9
520,43,1,1,1,1,1,2,1,8
531,43,2,2,1,2,1,2,1,11
532,43,2,1,2,2,2,1,2,12
533,43,2,2,1,2,1,2,1,11
536,43,2,2,2,2,2,1,2,13
537,43,2,2,2,2,2,2,1,13
541,43,1,2,1,1,1,1,1,8
543,43,1,2,1,1,2,1,2,10
544,43,2,3,2,2,2,2,2,15
546,43,2,1,2,1,2,2,1,11
547,43,2,2,1,2,2,2,1,12
548,43,2,2,2,2,2,2,2,14
549,43,1,2,1,1,2,1,2,10
553,43,2,1,1,2,1,1,1,9
554,43,1,2,2,1,2,1,2,11
555,43,2,2,1,2,2,2,1,12
556,43,2,1,2,1,2,1,2,11
558,43,2,2,1,2,2,2,1,12
560,43,1,2,1,1,1,2,1,10
573,43,2,1,1,2,1,2,1,10
576,43,2,3,2,2,2,2,2,15
577,43,1,2,1,1,1,2,1,9
580,43,1,1,2,1,1,1,1,8
585,43,1,1,2,1,1,2,1,9
588,43,1,1,2,1,1,1,1,8
593,43,2,2,2,2,2,2,2,14
595,43,2,2,2,2,2,2,2,14
598,43,2,2,2,1,2,2,1,12
599,43,1,1,1,2,1,1,1,8
601,43,1,1,2,1,1,1,1,8
604,43,2,2,1,2,1,2,1,11
605,43,2,2,1,2,2,2,1,12
608,43,2,1,2,2,2,2,2,13
611,43,2,1,2,1,2,1,2,11
614,43,2,1,1,2,1,1,1,9
616,43,2,1,2,2,1,2,2,12
618,43,2,2,1,2,2,2,2,13
622,43,1,2,1,2,2,1,2,11
627,43,2,1,2,2,2,1,2,12
628,43,1,2,1,2,2,1,2,11
630,43,1,2,1,1,2,1,1,9
631,43,1,2,2,1,2,1,2,11
634,43,1,2,1,1,1,2,1,9
635,43,1,2,1,1,1,1,1,8
637,43,1,1,2,1,1,2,1,9
638,43,1,1,2,1,1,2,1,9
639,43,2,2,1,2,1,2,1,11
640,43,1,1,1,1,1,1,2,8
642,43,1,1,1,1,1,2,1,8
644,43,2,2,1,2,1,2,1,11
649,43,2,1,2,1,2,1,1,10
661,43,1,2,1,2,1,2,1,10
662,43,2,1,2,1,1,2,1,10
666,43,1,2,1,1,2,1,2,10
668,43,1,2,1,1,1,2,1,9
669,43,2,2,1,2,1,2,1,11
670,43,2,1,2,1,2,1,1,10
672,43,2,1,2,1,2,2,1,11
674,43,1,1,1,2,1,1,1,8
677,43,2,1,1,1,2,1,1,9
680,43,1,2,1,1,1,2,1,9
685,43,1,1,2,1,1,1,1,8
686,43,1,1,1,1,1,2,1,8
687,43,2,1,1,1,1,1,1,8
688,43,3,2,2,2,2,2,2,15
689,43,2,1,1,1,2,1,1,9
690,43,2,2,2,2,2,2,1,13
691,43,2,1,2,1,2,2,1,11
694,43,2,1,2,1,2,2,1,11
699,43,2,2,2,1,2,2,1,12
705,43,2,2,1,2,1,2,1,11
708,43,1,2,1,2,1,2,2,11
712,43,2,1,2,1,2,2,1,11
715,43,1,2,1,1,2,1,2,10
716,43,2,1,2,2,2,2,2,13
718,43,2,2,2,1,2,2,2,13
721,43,2,2,1,2,1,2,1,11
722,43,1,2,1,1,2,1,2,10
723,43,2,2,1,2,2,2,1,12
725,43,1,2,2,2,1,2,2,12
728,43,2,1,2,2,2,1,2,12
731,43,2,2,1,2,2,2,1,12
734,43,2,2,2,2,2,2,2,14
735,43,1,2,1,2,1,2,2,11
740,43,2,2,2,2,2,2,1,13
745,43,2,1,2,1,2,1,1,10
752,43,2,1,2,2,2,2,2,13
754,43,2,1,1,2,1,2,1,10
755,43,1,2,1,1,1,1,1,8
756,43,1,2,2,1,2,2,2,12
757,43,1,1,2,1,1,1,1,8
758,43,1,1,2,1,1,2,1,9
761,43,1,2,1,2,1,2,1,10
762,43,3,2,2,2,3,2,2,16
764,43,1,1,2,1,2,1,2,10
765,43,1,2,2,2,2,2,2,13
766,43,1,1,2,1,1,1,1,8
767,43,1,2,1,1,2,1,1,9
768,43,2,2,1,2,1,2,1,11
769,43,2,1,1,2,1,1,1,9
771,43,1,1,1,1,2,1,1,8
772,43,1,2,1,2,1,2,1,10
773,43,2,1,1,1,2,1,1,9
774,43,2,2,1,2,1,2,1,11
777,43,2,2,1,2,2,2,2,13
779,43,2,2,2,2,2,2,1,13
780,43,2,1,1,2,1,2,1,10
781,43,2,1,2,2,1,2,1,11
782,43,2,1,2,2,1,2,1,11
787,43,2,1,2,2,2,1,2,12
791,43,1,1,1,1,2,1,1,8
793,43,1,2,1,1,1,2,1,9
794,43,1,2,2,2,1,2,2,12
799,43,2,2,2,2,2,2,2,14
803,43,2,2,2,1,2,2,2,13
805,43,1,1,2,1,1,1,1,8
806,43,3,3,2,3,2,3,2,18
809,43,1,1,2,1,1,1,1,8
810,43,2,2,2,2,2,3,2,15
813,43,1,2,2,1,2,1,2,11
815,43,1,2,1,2,1,2,2,11
816,43,1,2,1,1,1,1,1,8
817,43,2,3,2,3,2,3,2,17
818,43,1,2,1,1,1,1,1,8
819,43,2,1,2,2,2,2,2,13
821,43,1,2,1,2,1,1,2,10
829,43,2,2,2,1,2,2,1,12
835,43,1,2,1,2,1,2,1,10
836,43,1,1,1,1,1,2,1,8
844,43,2,1,2,2,1,2,2,12
848,43,1,1,2,1,1,2,1,9
849,43,2,2,2,2,2,2,2,14
850,43,2,2,2,2,2,1,2,13
853,43,2,2,1,2,2,2,1,12
855,43,1,2,1,1,2,1,2,10
859,43,2,1,1,1,2,1,1,9
862,43,2,1,2,2,1,2,2,12
864,43,2,1,2,1,2,1,1,10
865,43,1,2,1,2,1,2,2,11
866,43,1,2,1,2,1,2,2,11
868,43,1,1,1,1,1,2,1,8
874,43,1,2,2,2,1,2,2,12
875,43,1,2,1,1,1,2,1,11
877,43,1,2,1,1,1,2,1,9
881,43,1,1,1,1,1,1,2,8
887,43,1,2,2,1,2,1,2,11
889,43,1,2,1,1,2,1,2,10
894,43,1,1,2,1,2,1,2,10
899,43,2,1,1,1,2,1,1,9
901,43,1,2,1,1,1,2,1,9
903,43,1,1,2,1,1,1,1,8
904,43,1,2,1,1,2,1,2,10
906,43,2,1,1,1,2,1,1,9
907,43,2,2,2,2,2,2,1,13
908,43,2,1,1,1,1,1,1,8
913,43,1,2,1,1,1,1,1,8
914,43,2,1,1,1,2,1,1,9
915,43,2,1,2,1,1,2,1,10
916,43,2,1,1,2,1,1,1,9
919,43,2,2,2,1,2,2,1,12
923,43,2,2,2,2,2,2,2,14
928,43,1,2,1,2,2,1,2,11
929,43,2,2,2,2,2,2,1,13
930,43,2,2,2,2,2,2,1,13
931,43,2,1,2,2,2,1,2,12
942,43,1,2,2,2,1,2,1,11
943,43,1,2,1,1,2,1,2,10
944,43,2,2,1,2,1,2,1,11
947,43,2,1,1,1,2,1,1,9
948,43,2,1,2,1,2,2,1,11
950,43,1,1,1,1,1,2,1,8
952,43,1,2,1,2,1,2,2,11
954,43,2,1,2,2,2,2,2,13
955,43,2,2,1,2,1,2,1,11
959,43,2,2,2,2,2,3,2,15
963,43,2,1,2,1,2,2,1,11
964,43,1,2,1,1,1,1,1,8
967,43,1,1,1,1,2,1,1,8
968,43,2,1,2,1,2,2,1,11
969,43,1,2,2,1,2,2,2,12
973,43,2,1,2,2,1,2,2,12
974,43,1,2,1,1,1,1,1,8
975,43,2,1,1,1,2,1,1,9
976,43,2,2,2,2,2,2,2,14
981,43,1,2,1,2,1,2,2,11
987,43,1,2,1,2,2,1,2,11
988,43,2,2,1,2,1,2,1,11
989,43,2,1,1,1,2,1,1,9
990,43,2,2,2,1,2,2,1,12
991,43,1,2,1,1,1,2,1,9
992,43,1,1,1,1,2,1,1,8
994,43,1,2,1,1,2,1,2,10
999,43,2,2,1,2,2,2,1,12
1000,43,2,2,2,2,2,2,2,14
1001,43,1,1,2,1,1,2,1,9
1004,43,1,2,2,1,2,1,2,11
1006,43,2,2,2,2,2,2,2,14
1009,43,2,1,1,1,2,1,1,9
1010,43,1,2,2,1,2,1,2,11
1011,43,2,1,2,2,1,2,2,12
1014,43,2,2,1,2,2,2,1,12
1015,43,2,2,1,2,1,2,1,11
1016,43,2,2,2,2,2,2,2,14
1018,43,2,2,1,2,1,2,1,11
1023,43,1,1,2,1,1,1,1,8
1025,43,2,1,1,2,1,2,1,10
1027,43,2,2,2,2,2,2,2,14
1028,43,2,2,1,2,2,2,1,12
1029,43,2,1,2,1,2,1,1,10
1030,43,1,1,1,2,1,1,1,8
1035,43,1,2,2,1,2,2,2,12
1036,43,1,2,1,2,1,2,2,11
1037,43,2,2,2,2,2,2,2,14
1040,43,1,2,1,1,1,2,1,9
1041,43,2,2,2,2,2,3,2,15
1048,43,1,2,2,2,2,2,2,13
1059,43,1,1,1,2,1,1,1,8
1060,43,1,1,1,2,1,1,1,8
1064,43,2,1,2,2,1,2,1,11
1066,43,2,1,2,2,1,2,1,11
1068,43,2,2,2,1,2,2,2,13
1070,43,2,1,2,2,2,2,2,13
1071,43,2,2,2,2,1,2,2,13
1072,43,1,2,1,1,2,1,1,9
1076,43,1,2,2,1,2,1,2,11
1080,43,1,1,2,1,2,1,2,10
1081,43,1,2,1,1,2,1,2,10
1083,43,1,1,1,2,1,1,1,8
1084,43,2,3,3,2,3,3,3,19
1085,43,1,1,2,1,1,1,1,8
1091,43,1,2,1,1,2,1,2,10
1101,43,1,1,1,1,1,2,1,8
1103,43,2,2,2,2,2,1,2,13
1111,43,1,1,1,2,1,1,1,8
1112,43,2,2,2,2,2,2,1,13
1113,43,2,1,2,1,2,1,2,11
1120,43,2,1,2,1,2,1,1,10
1121,43,2,1,2,1,2,1,1,10
1122,43,2,1,2,1,2,1,1,10
1123,43,2,2,1,2,2,2,1,12
1124,43,1,1,2,1,1,2,1,9
1125,43,3,2,2,2,2,2,2,15
1126,43,2,2,1,2,2,1,2,12
1128,43,2,1,1,1,1,1,1,8
1129,43,2,1,2,1,2,1,1,10
1130,43,2,2,1,2,2,2,2,13
1132,43,1,2,1,2,2,1,2,11
1133,43,1,1,1,1,2,1,1,8
1136,43,2,2,2,1,2,2,1,12
1139,43,1,1,1,1,1,1,2,8
1141,43,2,2,3,2,2,3,2,16
1143,43,2,1,2,2,2,2,2,13
1146,43,1,1,2,1,1,1,1,8
1151,43,1,1,2,1,1,1,2,9
1152,43,2,1,2,2,2,1,2,12
1153,43,2,1,2,2,2,2,2,13
1154,43,2,2,1,2,1,2,1,11
1155,43,2,2,2,1,2,2,1,12
1156,43,1,2,1,1,2,1,1,9
1158,43,2,1,1,1,1,1,1,8
1164,43,2,2,2,1,2,2,1,12
1167,43,2,2,1,2,2,2,1,12
1168,43,2,2,1,2,2,2,1,12
1171,43,1,1,1,1,2,1,1,8
1173,43,1,2,2,1,2,2,2,12
1175,43,1,1,1,1,2,1,1,8
1179,43,2,1,2,1,2,1,1,10
1183,43,1,2,1,1,2,1,1,9
1192,43,1,2,1,1,1,2,1,9
1193,43,2,1,1,1,1,1,1,8
1194,43,2,2,1,2,1,2,1,11
1195,43,2,1,2,2,2,1,2,12
1197,43,1,2,1,1,2,1,1,9
1198,43,2,2,2,2,2,2,1,13
1199,43,2,1,2,2,2,1,2,12
1200,43,3,2,2,3,2,3,2,17
1201,43,2,1,2,1,2,2,1,11
1207,43,1,2,2,1,2,1,2,11
1209,43,2,2,2,1,1,2,2,12
1213,43,1,2,2,2,1,2,2,12
1215,43,2,2,1,2,2,2,1,12
1217,43,2,1,1,2,1,2,1,10
1218,43,2,1,1,2,1,2,1,10
1219,43,1,2,1,2,1,2,1,10
1220,43,2,1,2,1,2,2,1,11
1221,43,1,2,2,1,2,1,2,11
1222,43,2,2,1,2,2,2,2,13
1227,43,1,2,1,2,1,2,1,10
1230,43,1,1,2,1,1,1,1,8
1231,43,2,3,2,2,2,2,2,15
1233,43,2,2,2,2,2,2,2,14
1237,43,1,2,2,1,2,1,2,11
1239,43,1,2,1,1,2,1,2,10
1240,43,2,1,2,2,1,2,2,12
1242,43,2,1,2,1,2,1,1,10
1244,43,1,2,1,1,1,2,1,9
1245,43,2,3,2,2,3,2,2,16
1247,43,2,1,1,1,2,1,1,9
1248,43,2,2,1,2,2,1,2,12
1253,43,2,1,2,2,2,1,2,12
1256,43,2,1,2,1,2,1,1,10
1268,43,2,2,2,2,2,2,2,14
1270,43,1,2,1,1,1,2,1,9
1271,43,1,2,2,2,2,2,2,13
1279,43,1,1,2,1,1,1,1,8
1280,43,2,2,2,2,2,1,2,13
1281,43,2,1,2,1,2,1,1,10
1284,43,1,2,1,1,2,1,1,9
1285,43,1,2,1,1,2,1,2,10
1291,43,2,2,1,2,1,2,1,11
1293,43,1,2,1,2,1,2,1,10
1297,43,2,2,2,1,2,2,1,12
1298,43,2,2,2,2,2,2,2,14
1302,43,2,2,2,2,2,2,1,13
1303,43,1,2,2,1,2,1,2,11
1306,43,2,2,1,2,2,2,2,13
1310,43,2,1,2,1,2,2,1,11
1311,43,2,1,2,1,2,1,2,11
1313,43,1,1,1,1,2,1,1,8
1315,43,1,1,1,1,1,2,1,8
1321,43,2,1,2,1,2,2,1,11
1322,43,1,2,1,2,1,1,2,10
1324,43,2,1,2,2,2,1,2,12
1326,43,2,1,2,1,2,2,1,11
1352,43,1,2,1,1,1,2,1,9
1353,43,1,1,1,2,1,1,2,9
1355,43,2,1,2,1,2,1,2,11
1358,43,1,2,1,1,1,1,1,8
1359,43,2,2,2,2,1,2,2,13
1360,43,1,1,2,1,1,1,1,8
1361,43,1,1,2,2,2,2,1,11
1362,43,2,2,2,2,2,2,2,14
1363,43,2,2,2,2,2,1,2,13
1364,43,2,1,1,2,1,2,1,10
1367,43,1,2,1,1,1,1,1,8
1368,43,2,2,2,2,2,1,2,13
1375,43,1,2,1,1,1,1,1,8
1379,43,1,2,1,1,2,1,2,10
1380,43,2,1,2,2,1,2,2,12
1383,43,2,1,1,1,2,1,1,9
1385,43,1,2,1,1,1,2,1,9
1386,43,2,1,2,2,2,1,2,12
1387,43,1,2,1,2,1,1,2,10
1390,43,1,2,2,2,2,2,1,12
1392,43,2,1,1,2,1,2,1,10
1394,43,2,2,2,2,2,2,2,14
1397,43,1,2,1,1,2,1,1,9
1400,43,1,1,2,1,1,2,1,9
1403,43,1,2,2,2,1,2,2,12
1404,43,1,2,1,1,1,2,1,9
1407,43,1,2,1,1,2,1,2,10
1412,43,2,1,1,1,1,1,1,8
1414,43,2,1,2,2,1,2,2,12
1415,43,1,2,1,2,1,2,1,10
1424,43,2,2,2,2,2,2,2,14
1426,43,2,1,2,1,1,2,1,10
1427,43,1,2,1,1,2,1,1,9
1432,43,1,1,2,1,1,1,1,8
1439,43,1,2,1,1,1,2,1,9
1440,43,1,1,2,1,1,1,1,8
1445,43,2,2,1,2,2,1,2,12
1446,43,2,1,1,2,1,2,1,10
1447,43,2,1,2,1,2,2,1,11
1452,43,1,2,1,2,1,2,1,10
1458,43,2,1,2,2,1,2,1,11
1463,43,2,1,2,2,2,1,2,12
1465,43,1,2,1,1,2,1,1,9
1469,43,2,1,2,1,2,1,2,11
1470,43,2,1,2,1,2,1,1,10
1474,43,1,1,1,1,1,1,2,8
1478,43,2,2,2,1,2,2,1,12
1482,43,2,1,2,2,2,1,2,12
1486,43,1,2,1,1,2,1,1,9
1488,43,2,1,2,1,2,2,1,11
1490,43,1,1,2,1,1,1,1,8
1493,43,1,1,1,1,2,1,1,8
1495,43,2,1,2,1,2,2,1,11
1497,43,2,1,2,2,1,2,2,12
1500,43,2,1,1,1,2,1,1,9
1503,43,2,1,1,1,1,1,1,8
1505,43,2,1,2,2,2,1,2,12
1513,43,2,2,1,2,2,2,1,12
1514,43,2,2,1,2,2,2,1,12
1519,43,2,2,2,2,2,2,2,14
1523,43,2,1,1,2,1,1,1,9
1524,43,1,2,1,1,1,1,1,8
1525,43,1,2,1,2,1,1,2,10
1527,43,2,2,1,2,2,2,1,12
1528,43,1,1,1,2,1,1,1,8
1529,43,1,2,2,1,2,2,2,12
1530,43,2,2,1,2,1,2,1,11
1532,43,2,2,2,2,1,2,2,13
1533,43,1,1,1,2,1,1,2,9
1535,43,2,2,1,2,2,2,1,12
1536,43,2,1,2,1,1,2,1,10
1539,43,2,2,1,2,1,2,1,11
1541,43,2,1,1,2,1,1,1,9
1543,43,2,1,1,1,1,2,1,9
1544,43,1,2,1,1,2,1,1,9
1545,43,3,2,3,2,2,3,2,17
1552,43,1,2,1,2,2,1,2,11
1554,43,2,1,2,1,2,1,1,10
1555,43,2,2,2,1,2,2,1,12
1556,43,1,1,1,2,1,1,1,8
1560,43,1,2,1,1,2,1,1,9
1561,43,1,1,1,1,1,1,2,8
1564,43,2,2,1,2,1,2,1,11
1565,43,2,1,1,2,1,1,1,9
1567,43,2,2,2,2,2,2,2,14
1568,43,2,1,2,2,1,2,2,12
1569,43,1,2,2,2,1,2,2,12
1570,43,2,2,2,2,2,2,2,14
1576,43,2,1,2,2,1,2,2,12
1577,43,1,2,1,2,1,2,1,10
1579,43,1,2,2,1,2,1,2,11
1581,43,2,2,2,2,2,2,2,14
1583,43,1,2,1,2,2,1,2,11
1584,43,2,1,2,1,2,1,2,11
1588,43,2,2,2,1,2,2,2,13
1591,43,2,1,2,1,1,2,1,10
1593,43,1,2,1,1,1,1,1,9
1595,43,2,1,2,2,2,2,2,13
1604,43,1,1,1,2,1,1,1,8
1606,43,1,2,2,1,2,2,2,12
1607,43,1,1,1,1,2,1,1,8
1612,43,1,2,2,2,2,2,2,13
1613,43,3,2,2,2,3,2,2,16
1614,43,1,2,1,1,1,1,1,8
1622,43,1,2,2,2,2,2,2,13
1624,43,1,1,2,2,1,1,1,9
1626,43,2,1,2,1,2,1,1,10
1631,43,2,1,2,1,2,1,2,11
1632,43,2,1,2,2,1,2,1,11
1634,43,2,1,2,1,1,2,1,10
1636,43,1,1,2,1,1,1,1,8
1637,43,1,2,1,1,2,1,2,10
1638,43,1,1,2,1,1,1,1,8
1640,43,1,1,1,2,1,1,1,8
1642,43,1,2,1,2,1,2,2,11
1645,43,1,1,1,1,1,1,2,8
1654,43,1,2,2,1,2,2,2,12
1656,43,2,1,2,2,1,2,1,11
1657,43,2,1,2,1,2,2,1,11
1658,43,1,2,1,1,2,1,1,9
1660,43,1,1,1,2,1,1,1,8
1662,43,2,1,2,1,2,1,1,10
1663,43,2,2,2,2,2,2,1,13
1664,43,2,2,2,2,2,1,2,13
1666,43,1,2,1,1,1,1,1,8
1671,43,2,1,2,1,2,1,1,10
1677,43,1,1,1,2,1,1,1,8
1679,43,1,1,2,1,2,1,2,10
1680,43,1,2,1,2,1,2,1,10
1682,43,1,1,2,1,1,2,1,9
1685,43,2,1,2,1,2,1,2,11
1686,43,2,1,1,2,1,1,1,9
1688,43,2,2,2,2,2,2,2,14
1691,43,2,2,1,2,2,2,1,12
1692,43,1,2,1,1,2,1,1,9
1693,43,1,2,1,1,1,1,1,8
1694,43,1,2,1,2,1,2,1,10
1695,43,2,2,2,2,2,2,2,14
1696,43,2,1,2,2,2,2,2,13
1699,43,1,1,1,1,1,2,1,8
1700,43,2,2,2,2,2,2,2,14
1708,43,2,2,2,1,2,2,2,13
1710,43,2,1,2,1,2,1,1,10
1712,43,2,2,1,2,1,2,1,11
1716,43,2,1,1,1,1,1,1,8
1717,43,1,1,2,1,1,1,1,8
1718,43,2,2,2,2,2,1,2,13
1720,43,1,1,2,1,1,1,1,8
1721,43,2,2,2,2,2,1,2,13
1722,43,1,1,2,1,1,1,1,8
1734,43,2,1,2,1,2,2,1,11
1735,43,2,1,2,1,2,2,1,11
1737,43,1,1,1,1,1,1,2,8
1738,43,2,1,2,2,1,2,2,12
1739,43,2,2,1,2,1,2,1,11
1740,43,1,2,1,2,2,1,2,11
1741,43,2,1,1,2,1,2,1,10
1744,43,1,2,1,2,1,2,2,11
1746,43,1,1,2,1,1,1,2,9
1747,43,1,2,2,1,2,1,2,11
1748,43,2,1,2,2,2,1,2,12
1750,43,2,2,2,2,2,2,1,13
1753,43,1,2,1,1,2,1,2,10
1757,43,2,2,2,1,2,2,2,13
1759,43,2,1,1,1,1,1,1,8
1762,43,2,2,1,2,2,2,2,13
1764,43,1,1,1,1,1,1,2,8
1765,43,1,2,1,2,1,2,1,10
1767,43,3,2,2,2,3,2,2,16
1770,43,2,1,1,1,2,1,1,9
1773,43,2,2,1,2,1,2,1,11
1774,43,1,1,1,1,1,1,2,8
1782,43,1,2,1,2,1,2,1,10
1785,43,2,2,1,2,1,2,1,11
1788,43,2,1,1,2,1,1,1,9
1790,43,2,1,1,2,1,2,1,10
1796,43,2,1,1,2,1,2,1,10
1797,43,2,2,2,2,2,2,1,13
1799,43,2,1,1,2,1,2,1,10
1802,43,2,2,2,2,2,1,2,13
1803,43,2,2,1,2,2,2,1,12
1804,43,1,2,1,1,1,1,1,8
1806,43,1,2,1,1,2,1,2,10
1810,43,2,1,2,1,1,2,1,10
1811,43,2,2,1,2,2,2,1,12
1812,43,1,2,1,2,1,2,1,10
1813,43,2,2,2,2,2,2,1,13
1814,43,2,1,2,1,2,1,1,10
1819,43,2,3,2,2,2,2,2,15
1820,43,2,2,1,2,2,1,2,12
1821,43,1,1,2,1,1,1,2,9
1830,43,1,2,2,1,2,2,2,12
1831,43,2,2,2,2,2,2,2,14
1832,43,1,2,1,1,1,1,1,8
1833,43,2,2,2,3,2,2,3,16
1835,43,1,2,1,2,1,1,2,10
1836,43,2,1,1,2,1,2,1,10
1842,43,3,2,2,3,2,2,2,16
1846,43,1,1,2,1,1,1,1,8
1847,43,1,1,2,1,1,1,1,8
1848,43,1,1,1,2,1,1,2,9
1849,43,1,1,1,1,1,1,2,8
1850,43,2,2,1,2,1,2,1,11
1852,43,1,1,1,1,1,2,1,8
1853,43,2,1,1,1,1,1,2,9
1857,43,2,2,2,2,2,2,2,14
1859,43,1,2,1,1,2,1,2,10
1861,43,2,1,2,1,1,2,1,10
1862,43,2,1,2,1,1,2,1,10
1863,43,2,1,2,1,2,1,2,11
1864,43,2,2,2,1,2,2,2,13
1867,43,2,1,2,1,2,1,1,10
1868,43,1,1,1,1,1,2,1,8
1870,43,2,1,2,1,2,1,1,10
1871,43,2,1,1,1,2,1,1,9
1872,43,1,1,1,1,2,1,1,8
1873,43,2,1,2,1,1,2,1,10
1874,43,2,2,1,2,1,2,1,11
1876,43,2,2,1,2,1,2,1,11
1877,43,1,2,1,1,1,2,1,9
1879,43,2,1,2,1,2,1,2,11
1884,43,1,2,1,2,1,2,2,11
1885,43,2,1,2,2,1,2,1,11
1886,43,2,1,1,1,2,1,1,9
1887,43,1,2,2,1,2,2,2,12
1889,43,2,2,1,2,1,2,1,11
1890,43,1,1,2,1,1,2,1,9
1891,43,2,1,2,1,1,2,1,10
1892,43,2,2,1,2,1,2,1,11
1894,43,2,1,1,2,1,1,1,9
1897,43,1,2,1,1,2,1,1,9
1899,43,2,1,1,1,1,1,1,8
1903,43,2,2,2,2,3,2,2,15
1906,43,1,2,1,2,1,2,1,10
1907,43,2,2,2,2,2,2,2,14
1911,43,1,1,2,1,1,1,1,8
1913,43,1,1,1,1,1,1,2,8
1914,43,2,2,1,2,1,2,1,11
1917,43,1,1,1,1,1,2,1,8
1918,43,1,2,1,2,2,1,2,11
1921,43,1,1,1,1,2,1,1,8
1922,43,2,1,1,1,2,1,1,9
1923,43,2,1,1,1,1,1,1,8
1924,43,2,2,1,2,2,2,1,12
1926,43,1,1,1,1,1,1,2,8
1927,43,2,2,1,2,2,2,1,12
1928,43,1,1,2,1,1,1,2,9
1929,43,1,2,1,1,1,2,1,9
1930,43,2,2,2,2,2,2,2,14
1932,43,1,2,1,1,2,1,1,9
1935,43,2,2,2,2,2,2,3,15
1937,43,2,2,1,2,2,1,2,12
1938,43,1,1,2,1,1,2,1,9
1939,43,1,1,2,1,1,1,1,8
1940,43,1,1,1,2,1,2,1,9
1943,43,1,1,1,1,1,1,2,8
1946,43,2,1,2,1,2,1,1,10
1947,43,2,1,2,1,2,2,1,11
1948,43,1,2,1,2,1,2,1,10
1951,43,1,2,1,2,1,2,1,10
1952,43,1,2,1,1,1,2,1,9
1954,43,1,2,2,1,2,2,2,12
1956,43,1,2,1,2,1,1,2,10
1958,43,1,2,1,2,1,2,1,10
1959,43,1,1,1,1,1,2,1,8
1960,43,1,2,2,2,1,2,2,12
1963,43,1,2,2,1,2,1,2,11
1970,43,1,1,1,2,1,1,1,8
1971,43,2,1,2,1,1,2,1,10
1973,43,2,2,1,2,1,2,1,11
1976,43,2,1,2,1,2,2,1,11
1979,43,2,1,2,1,2,1,1,10
1980,43,2,1,1,1,2,1,1,9
1981,43,2,2,1,2,2,2,1,12
1986,43,2,2,1,2,1,2,1,11
1993,43,1,1,1,1,2,1,1,8
1995,43,2,2,1,2,1,2,1,11
1996,43,2,2,1,2,2,2,1,12
1997,43,2,1,2,2,1,2,1,11
1999,43,1,1,1,2,1,1,1,8
2000,43,1,1,1,1,2,1,1,8
2002,43,2,1,2,1,2,1,1,10
2003,43,1,1,1,1,1,2,1,8
2005,43,1,1,1,1,1,2,1,8
2010,43,2,2,2,3,2,2,2,15
2012,43,2,2,2,1,2,2,1,12
2013,43,1,1,2,1,1,1,1,8
2015,43,1,1,2,1,1,1,2,9
2016,43,1,1,1,2,1,1,2,9
2019,43,2,1,2,1,2,1,2,11
2021,43,1,2,1,2,1,2,1,10
2022,43,2,1,2,2,1,2,1,11
2027,43,2,2,1,2,1,2,1,11
2032,43,2,2,1,2,2,2,2,13
2033,43,1,1,2,1,1,1,1,8
2035,43,2,1,1,1,2,1,1,9
2036,43,1,2,1,2,1,2,2,11
2038,43,1,2,1,1,1,2,1,9
2040,43,1,2,1,1,1,1,1,8
2041,43,1,2,1,2,2,1,2,11
2046,43,2,1,1,2,1,2,1,10
2047,43,2,2,1,2,2,2,1,12
2049,43,2,2,2,2,2,2,2,14
2050,43,1,1,1,1,1,1,2,8
2051,43,2,2,1,2,2,2,1,12
2059,43,2,1,2,1,2,1,1,10
2061,43,1,2,1,2,1,2,1,10
2062,43,2,2,2,2,1,2,2,13
2063,43,1,2,2,2,1,2,2,12
2064,43,1,2,1,1,2,1,1,9
2065,43,2,1,1,1,2,1,1,9
2073,43,2,1,2,2,2,1,2,12
2078,43,2,2,2,2,2,2,2,14
2080,43,1,1,2,1,1,1,2,9
2081,43,1,1,1,1,2,1,1,8
2082,43,1,2,1,2,1,2,1,10
2087,43,2,1,2,2,1,2,1,11
2090,43,1,2,1,1,1,1,1,8
2091,43,2,1,1,2,1,1,1,9
2092,43,3,2,2,3,2,2,2,16
2095,43,1,2,1,2,2,1,2,11
2097,43,2,1,2,1,2,2,1,11
2101,43,2,2,2,2,1,2,2,13
2102,43,1,1,2,1,2,1,2,10
2104,43,2,1,2,1,2,1,1,10
2107,43,2,2,2,1,2,2,2,13
2108,43,2,2,2,2,2,2,1,13
2111,43,2,2,1,2,2,2,2,13
2112,43,2,1,2,2,1,2,2,12
2113,43,2,3,2,3,2,3,2,17
2114,43,1,2,1,1,1,1,1,8
2115,43,2,1,1,1,2,1,1,9
2116,43,1,1,2,1,1,2,1,9
2118,43,1,2,1,1,2,1,2,10
2119,43,2,1,2,1,2,1,1,10
2123,43,2,1,2,2,1,2,1,11
2124,43,1,1,2,1,1,2,1,9
2129,43,2,1,2,1,2,1,2,11
2133,43,2,1,2,1,2,1,1,10
2138,43,2,1,2,1,2,1,1,10
2141,43,2,1,2,1,2,1,1,10
2142,43,2,2,1,2,2,1,2,12
2143,43,2,2,1,2,2,2,1,12
2147,43,1,2,2,1,2,2,2,12
2149,43,2,3,3,3,2,3,3,19
2150,43,1,1,2,1,1,1,1,8
2153,43,2,1,2,2,2,1,2,12
2154,43,2,1,2,2,2,1,2,12
2155,43,1,2,1,2,1,2,2,11
2156,43,2,1,1,2,1,2,1,10
2157,43,2,1,2,1,2,1,1,10
2159,43,1,1,1,1,2,1,1,8
2169,43,2,1,2,1,2,2,1,11
2170,43,2,2,2,1,2,2,1,12
2174,43,2,1,1,1,2,1,1,9
2175,43,1,1,2,1,1,1,1,8
2176,43,1,1,2,1,1,2,1,9
2183,43,1,2,2,1,2,2,2,12
2184,43,2,1,2,2,1,2,2,12
2191,43,2,2,2,1,2,2,2,13
2193,43,2,1,2,2,1,2,1,11
2194,43,1,2,1,2,1,2,1,10
2196,43,2,2,2,2,1,2,2,13
2197,43,2,3,2,2,2,2,2,15
2199,43,3,2,3,3,2,3,2,18
2201,43,2,2,1,2,2,2,2,13
2204,43,1,2,1,2,2,1,2,11
2205,43,2,1,2,1,2,2,1,11
2208,43,1,1,2,1,1,1,2,9
2209,43,2,1,2,2,1,2,2,12
2210,43,2,2,1,2,1,2,1,11
2211,43,2,1,2,1,2,1,1,10
2213,43,1,1,1,1,2,1,1,8
2214,43,1,1,1,1,2,1,1,8
2221,43,2,1,1,2,1,1,1,9
2222,43,2,1,2,2,2,2,1,12
2225,43,2,2,2,1,2,2,2,13
2227,43,2,1,2,1,2,1,2,11
2236,43,2,2,1,2,2,2,2,13
2237,43,2,2,1,2,2,2,1,12
2239,43,1,2,1,1,2,1,1,9
2241,43,1,2,2,2,1,2,2,12
2242,43,1,2,2,1,2,1,2,11
2244,43,2,1,2,1,2,2,1,11
2245,43,2,1,1,1,2,1,1,9
2247,43,1,2,1,1,2,1,2,10
2249,43,2,2,1,2,2,1,2,12
2251,43,1,2,1,1,2,1,2,10
2252,43,2,1,2,1,2,1,1,10
2253,43,1,1,1,1,1,2,1,8
2258,43,2,1,2,1,2,1,1,10
2259,43,1,2,1,1,2,1,1,9
2264,43,1,2,1,1,2,1,1,9
2265,43,1,2,1,1,1,1,1,8
2267,43,1,2,1,1,1,2,1,9
2269,43,2,1,2,1,2,1,2,11
2270,43,1,2,1,2,1,2,1,10
2271,43,2,2,1,2,1,2,1,11
2273,43,2,1,2,1,2,2,1,11
2274,43,2,1,1,2,1,1,1,9
2277,43,1,2,1,1,2,1,1,9
2279,43,1,2,1,1,1,2,1,9
2281,43,2,2,1,2,2,2,2,13
2282,43,2,2,2,1,2,2,1,12
2284,43,2,1,1,1,1,1,1,8
2285,43,1,1,2,1,1,2,1,10
2286,43,2,1,2,1,1,2,1,10
2287,43,2,1,1,2,1,2,1,10
2288,43,1,2,1,1,1,1,1,8
2289,43,2,2,1,2,2,2,1,12
2295,43,1,1,1,1,1,1,2,8
2299,43,1,2,2,1,2,1,2,11
2300,43,1,2,1,1,2,1,1,9
2306,43,1,1,1,2,1,1,1,8
2307,43,2,1,2,1,1,2,1,10
2309,43,2,1,2,1,2,1,1,10
2310,43,1,2,1,2,1,1,2,10
2313,43,2,1,2,1,1,2,1,10
2318,43,2,1,2,1,2,1,2,11
2319,43,1,2,1,1,2,1,1,9
2322,43,1,1,1,1,2,1,1,8
2330,43,2,1,2,1,2,1,2,11
2331,43,2,2,2,1,2,2,2,13
2336,43,2,2,2,2,2,2,1,13
2337,43,1,1,2,1,1,1,1,8
2341,43,1,2,1,2,1,2,1,10
2348,43,2,2,2,2,2,3,2,15
2351,43,2,2,1,2,2,2,2,13
2352,43,2,1,1,2,1,2,1,10
2354,43,1,2,1,1,2,1,2,10
2355,43,1,1,1,1,1,2,1,8
2359,43,2,1,2,1,2,1,2,11
2361,43,2,1,1,1,1,1,1,8
2362,43,2,2,1,2,2,2,1,12
2365,43,2,3,2,3,2,3,3,18
2366,43,1,1,1,2,1,1,2,9
2369,43,1,1,2,1,1,1,1,8
2370,43,1,2,1,1,1,1,1,8
2371,43,1,2,1,2,1,1,2,10
2373,43,1,1,1,1,2,1,1,8
2386,43,2,1,2,2,2,1,2,12
2388,43,2,2,1,2,1,2,1,11
2399,43,2,1,2,1,2,2,1,11
2401,43,1,2,1,2,2,1,2,11
2403,43,1,2,1,2,1,2,1,10
2420,43,1,1,1,1,2,1,1,8
2421,43,1,1,2,1,1,2,1,9
2422,43,1,1,2,1,1,1,2,9
2428,43,2,1,2,2,2,1,2,12
2432,43,2,2,2,1,2,2,1,12
2438,43,2,1,2,1,2,1,2,11
2439,43,1,2,1,1,1,1,1,8
2443,43,2,2,2,2,1,2,2,13
2444,43,1,2,1,1,2,1,1,9
2445,43,2,2,2,2,2,2,2,14
2446,43,1,1,2,1,1,2,1,9
2459,43,2,1,1,2,1,2,1,10
2464,43,1,2,2,1,2,1,2,11
2472,43,2,2,2,2,2,2,2,14
2474,43,2,1,2,1,1,2,1,10
2479,43,2,1,2,1,2,2,1,11
2480,43,2,1,1,2,1,2,1,10
2481,43,1,2,1,1,1,2,1,9
2482,43,1,1,2,1,1,1,1,8
2484,43,1,1,1,1,1,1,2,8
2490,43,2,1,2,2,1,2,2,12
2502,43,1,2,1,2,1,2,1,10
2504,43,2,1,1,2,1,2,1,10
2505,43,2,1,2,2,1,1,2,11
2506,43,2,1,2,1,2,1,2,11
2508,43,1,1,2,1,1,1,1,8
2512,43,1,2,1,2,2,1,2,11
2515,43,2,1,1,2,1,2,1,10
2516,43,2,1,2,1,1,2,1,10
2520,43,1,1,2,1,1,1,1,8
2527,43,2,1,2,1,2,1,1,10
2528,43,1,1,1,1,1,1,2,8
2529,43,1,1,1,1,1,1,2,8
2530,43,1,2,1,1,2,1,2,10
2531,43,2,1,1,2,1,2,1,10
2533,43,2,2,1,2,1,2,1,11
2537,43,1,2,1,1,2,1,1,9
2540,43,1,2,2,1,2,1,2,11
2541,43,1,2,1,2,1,2,1,10
2543,43,1,2,1,1,1,2,1,9
2544,43,1,1,2,1,2,1,2,10
2545,43,2,1,2,1,2,2,1,11
2547,43,1,1,2,1,1,1,1,8
2548,43,1,2,1,1,1,2,1,9
2549,43,1,1,2,1,1,2,1,9
2554,43,1,1,1,1,2,1,1,8
2559,43,1,2,2,2,1,2,2,12
2561,43,1,2,1,1,2,1,1,9
2565,43,1,2,1,1,2,1,2,10
2566,43,2,2,1,2,1,2,1,11
2571,43,2,2,1,2,2,2,1,12
2574,43,2,1,1,2,1,2,1,10
2575,43,2,2,2,1,2,2,1,12
2581,43,2,2,1,2,2,2,1,12
2585,43,2,1,2,1,2,1,2,11
2586,43,2,2,2,2,1,2,2,13
2587,43,2,1,1,1,2,1,1,9
2588,43,2,2,1,2,2,2,1,12
2591,43,2,2,2,2,1,2,2,13
2592,43,2,2,2,2,2,2,2,14
2593,43,1,2,1,2,1,2,1,10
2594,43,2,1,2,2,2,1,2,12
2595,43,2,2,1,2,1,2,1,11
2596,43,1,2,1,2,2,1,2,11
2597,43,2,2,2,1,2,2,1,12
2598,43,2,2,2,1,2,2,1,12
2599,43,1,2,1,2,1,2,1,10
2604,43,2,1,2,1,2,2,1,11
2605,43,1,1,1,1,1,1,1,8
2607,43,2,1,2,1,2,1,2,11
2610,43,1,1,2,1,1,1,1,8
2612,43,2,2,2,2,2,2,1,13
2613,43,1,2,1,1,2,1,2,10
2615,43,1,2,1,1,2,1,2,10
2618,43,1,1,2,1,1,2,1,9
2627,43,1,2,1,1,1,2,1,9
2629,43,2,2,2,2,2,2,1,13
2630,43,2,1,2,1,2,1,2,11
2631,43,2,2,1,2,2,2,1,12
2634,43,1,1,1,1,1,1,2,8
2638,43,2,1,2,2,2,1,2,12
2639,43,2,1,1,2,1,2,1,10
2640,43,1,2,2,1,2,2,2,12
2642,43,1,1,2,1,1,1,1,8
2643,43,1,2,1,1,1,2,1,9
2648,43,1,1,1,1,1,2,1,8
2650,43,1,2,2,1,2,1,2,11
2651,43,1,2,1,2,1,1,2,10
2656,43,1,2,1,1,2,1,1,9
2660,43,1,2,1,1,1,2,1,9
2663,43,2,1,2,2,1,2,2,12
2665,43,2,1,2,1,1,2,1,10
2667,43,1,2,1,2,1,2,1,10
2674,43,2,1,2,1,2,2,1,11
2679,43,1,2,1,1,1,2,1,9
2682,43,1,1,2,1,1,2,1,9
2684,43,2,1,2,2,1,2,1,11
2687,43,2,2,2,2,1,2,2,13
2690,43,2,1,2,1,1,2,1,10
2692,43,1,1,2,1,1,1,1,8
2693,43,1,1,1,1,1,2,1,8
2695,43,1,1,2,1,1,2,1,9
2697,43,1,2,1,1,1,1,1,8
2702,43,2,2,1,2,2,2,1,12
2704,43,1,1,1,2,1,1,1,8
2713,43,1,2,2,1,2,1,2,11
2715,43,1,2,1,1,1,2,1,9
2720,43,1,1,1,1,1,2,1,8
2723,43,2,2,1,2,1,2,1,11
2726,43,1,1,1,1,1,1,2,8
2727,43,1,1,2,1,1,1,1,8
2732,43,2,1,1,1,1,1,1,8
2733,43,1,2,1,2,1,2,1,10
2739,43,1,1,1,2,1,1,1,8
2753,43,1,1,1,1,1,1,2,8
2755,43,1,1,1,1,1,2,1,8
2758,43,1,1,1,1,2,1,1,8
2763,43,1,2,1,2,1,2,1,10
2765,43,2,2,2,2,2,2,1,13
2767,43,2,2,2,1,2,2,2,13
2768,43,1,2,1,1,2,1,1,9
2769,43,2,1,2,2,2,2,2,13
2777,43,1,2,2,2,1,2,2,12
2781,43,2,1,1,2,1,2,1,10
2786,43,2,2,1,2,1,2,1,11
2788,43,1,1,1,1,1,2,1,8
2789,43,1,2,2,1,2,1,2,11
2791,43,2,2,2,1,2,2,2,13
2793,43,2,2,2,2,3,2,2,15
2796,43,1,2,1,2,2,1,2,11
2799,43,1,1,2,1,1,1,1,8
2803,43,2,2,2,2,2,2,2,14
2806,43,2,1,2,1,2,1,1,10
2807,43,2,2,1,2,1,2,1,11
2808,43,2,2,2,2,2,2,2,14
2809,43,2,2,2,2,2,2,1,13
2812,43,2,1,2,1,2,1,1,10
2814,43,2,2,1,2,2,2,2,13
2817,43,2,1,2,2,1,2,2,12
2818,43,1,2,1,2,1,2,2,11
2820,43,2,2,2,1,2,2,2,13
2821,43,1,2,1,2,1,2,1,10
2823,43,3,2,3,2,2,3,2,17
2825,43,2,2,2,2,2,2,1,13
2830,43,1,2,2,1,2,1,2,11
2836,43,2,2,1,2,1,2,1,11
2838,43,2,2,1,2,2,2,1,12
2843,43,2,1,2,1,2,1,1,10
2844,43,2,3,2,2,2,3,2,16
2847,43,2,1,2,1,2,1,2,11
2850,43,2,1,2,1,2,1,1,10
2852,43,1,2,2,2,1,2,2,13
2853,43,2,1,2,1,1,2,1,10
2854,43,1,2,1,2,1,2,2,11
2855,43,2,2,1,2,1,2,1,11
2857,43,1,2,2,1,2,1,2,11
2859,43,2,1,2,2,2,1,2,12
2860,43,1,2,2,2,1,2,2,12
2864,43,2,1,2,1,2,2,1,11
2869,43,2,1,1,2,1,2,1,10
2874,43,1,2,1,1,1,2,1,9
2881,43,1,2,1,1,1,2,1,9
2883,43,1,1,1,2,1,1,1,8
2886,43,2,1,2,2,1,2,2,12
2888,43,1,1,1,1,1,2,1,8
2889,43,1,2,1,1,1,1,1,8
2891,43,2,1,2,2,2,1,2,12
2894,43,2,1,2,2,1,2,1,11
2898,43,1,2,1,2,1,2,1,10
2902,43,1,2,1,1,2,1,1,9
2904,43,1,2,1,2,1,2,1,10
2910,43,2,2,1,2,1,2,1,11
2911,43,2,1,1,2,1,2,1,10
2913,43,2,1,1,2,1,2,1,10
2914,43,1,2,2,2,2,2,2,13
2916,43,2,1,1,2,1,2,1,10
2921,43,2,2,1,2,2,2,2,13
2922,43,2,1,2,1,2,2,1,11
2924,43,1,2,1,1,1,2,1,9
2927,43,2,1,2,2,2,1,2,12
2932,43,2,1,1,2,1,2,1,10
2937,43,1,1,2,1,1,2,1,9
2938,43,2,2,1,2,1,2,1,11
2939,43,1,2,1,1,2,1,1,9
2941,43,2,2,1,2,2,2,1,12
2950,43,1,2,1,1,2,1,2,10
2952,43,1,1,2,1,1,1,1,8
2953,43,2,2,1,2,2,2,2,13
2957,43,2,2,2,3,2,2,2,15
2958,43,2,1,2,1,2,2,1,11
2959,43,2,1,2,1,2,1,1,10
2962,43,2,1,1,2,1,2,1,10
2965,43,4,3,4,4,3,4,4,26
2966,43,2,2,2,2,3,2,3,16
2978,43,2,2,2,2,2,2,1,13
2988,43,1,2,1,2,1,2,1,11
2990,43,2,1,1,2,1,2,1,10
2991,43,1,1,1,2,1,1,1,8
2993,43,2,1,2,2,2,2,2,13
2994,43,1,1,1,1,1,2,1,8
2996,43,2,2,2,1,2,2,1,12
3004,43,1,1,1,1,1,1,2,8
3017,43,1,2,2,2,1,2,2,12
3035,43,1,1,1,1,1,2,1,8
3053,43,1,2,1,2,2,1,2,11
3055,43,2,2,2,2,2,2,2,14
3056,43,2,1,1,2,1,1,1,9
3057,43,2,2,2,2,2,2,2,14
3058,43,2,1,1,2,1,2,1,10
3059,43,2,2,1,2,2,1,2,12
3067,43,2,2,2,2,2,3,2,15
3102,43,1,1,1,1,1,2,1,8
3106,43,2,1,2,2,1,2,2,12
3107,43,1,2,1,2,2,1,2,11
3114,43,2,1,2,2,2,1,2,12
3118,43,2,2,1,2,2,2,1,12
3119,43,1,2,1,1,1,2,1,9
3136,43,1,1,1,2,1,1,1,8
3151,43,2,1,2,1,2,1,1,10
3159,43,2,1,2,1,2,1,2,11
3163,43,1,1,1,1,1,1,2,8
3169,43,1,1,2,1,1,2,1,9
3170,43,1,1,1,1,2,1,1,8
3197,43,2,1,2,1,1,2,1,10
3200,43,2,1,2,1,2,1,1,10
3205,43,1,2,1,1,2,1,2,10
3206,43,2,1,2,1,2,2,1,11
3207,43,1,2,1,2,1,2,1,10
3209,43,2,2,1,2,2,2,2,13
3210,43,2,1,1,2,1,2,1,10
3212,43,2,2,1,2,2,2,1,12
3213,43,2,1,2,2,2,2,2,13
3214,43,2,1,2,1,2,1,2,11
3217,43,2,2,2,2,2,3,2,15
3219,43,1,2,1,1,1,2,1,9
3220,43,1,2,1,1,1,2,1,9
3221,43,2,2,1,2,1,2,1,11
3222,43,1,1,2,1,1,1,1,8
3223,43,1,2,1,1,1,1,1,8
3224,43,3,3,3,3,2,3,3,20
3226,43,1,1,2,1,1,1,1,8
3228,43,1,1,2,1,1,1,2,9
3230,43,2,1,1,1,2,1,1,9
3233,43,2,2,2,2,2,2,2,14
3234,43,1,2,1,1,1,1,1,8
3237,43,1,2,1,1,1,1,1,8
3239,43,1,2,2,1,2,1,2,11
3241,43,1,2,1,1,1,1,1,8
3245,43,1,2,1,2,1,2,2,11
3250,43,1,2,1,1,2,1,2,10
3251,43,2,2,1,2,2,2,1,12
3252,43,2,1,2,2,1,2,1,11
3255,43,2,1,2,1,2,1,2,11
3261,43,2,1,2,1,2,2,1,11
3262,43,2,2,1,2,1,2,1,11
3266,43,1,1,2,1,1,2,1,9
3271,43,2,1,2,2,2,1,2,12
3278,43,1,2,1,2,1,2,2,11
3279,43,1,2,1,1,1,1,1,8
3280,43,2,1,1,2,1,2,1,10
3281,43,1,2,1,2,1,2,1,10
3282,43,1,1,1,1,1,1,2,8
3283,43,2,2,2,3,2,2,3,16
3286,43,2,1,1,2,1,1,1,9
3288,43,2,1,1,2,1,2,1,10
3292,43,1,2,1,1,2,1,2,10
3293,43,2,2,1,2,2,2,1,12
3295,43,2,2,2,2,2,2,2,14
3296,43,2,1,1,2,1,2,1,10
3302,43,1,2,2,1,2,2,2,12
3308,43,2,2,2,2,2,2,2,14
3320,43,1,1,2,1,1,1,2,9
3328,43,1,2,1,2,2,1,2,11
3331,43,2,1,1,1,2,1,1,9
3332,43,1,2,1,1,1,1,1,8
3334,43,2,1,1,1,1,1,1,8
3339,43,1,1,2,1,1,1,2,9
3347,43,2,2,2,2,2,2,2,14
3348,43,2,1,1,2,1,1,1,9
3349,43,1,2,1,2,1,2,1,10
3350,43,2,1,2,1,1,2,1,10
3351,43,2,1,2,2,1,2,1,11
3363,43,1,1,1,1,2,1,1,8
3364,43,1,2,1,1,1,2,1,9
3367,43,1,2,1,1,1,1,1,8
3370,43,2,1,2,1,2,1,2,11
3372,43,2,1,1,1,1,1,1,8
3379,43,1,1,1,2,1,1,1,8
3380,43,2,1,1,1,2,1,1,9
3382,43,1,2,1,1,1,2,1,9
3383,43,1,1,2,1,1,2,1,9
3387,43,2,2,1,2,1,2,1,11
3390,43,1,2,1,1,2,1,1,9
3402,43,1,2,1,1,2,1,1,9
3403,43,2,1,2,1,2,1,2,11
3404,43,2,1,2,1,2,2,1,11
3407,43,1,1,2,1,1,2,1,9
3409,43,2,1,2,2,2,1,2,12
3412,43,1,1,1,1,1,2,1,8
3418,43,1,2,1,2,1,2,1,10
3420,43,1,1,2,1,2,1,2,10
3423,43,1,1,2,1,1,1,2,9
3428,43,1,1,2,1,1,2,1,9
3429,43,2,1,1,1,1,2,1,9
3431,43,1,1,2,2,1,2,1,10
3433,43,1,1,2,2,1,2,2,11
3435,43,2,1,2,1,2,2,1,11
3436,43,2,1,1,2,1,2,1,10
3439,43,2,2,1,2,1,2,1,11
3454,43,2,2,1,2,2,1,2,12
3455,43,1,2,1,1,2,1,2,10
3461,43,1,1,2,1,1,1,1,8
3463,43,1,2,2,1,2,1,2,11
3464,43,2,1,2,2,1,2,1,11
3465,43,1,2,2,2,1,2,2,12
3469,43,2,1,2,2,1,2,1,11
3471,43,1,2,2,1,2,1,2,11
3472,43,2,2,2,2,2,2,2,14
3473,43,2,1,1,1,1,1,1,8
3474,43,2,1,1,2,1,2,1,10
3475,43,2,1,2,1,2,1,1,10
3476,43,2,2,2,2,2,2,2,14
3481,43,1,2,1,2,2,1,2,11
3485,43,1,1,2,1,1,2,1,9
3486,43,2,2,2,2,2,1,2,13
3489,43,2,2,1,2,1,2,1,11
3490,43,1,2,2,1,2,2,2,12
3491,43,1,1,2,1,1,1,1,8
3492,43,1,2,1,2,1,2,1,10
3495,43,2,3,2,2,2,2,2,15
3500,43,1,2,2,2,1,2,2,12
3503,43,1,1,2,1,1,1,1,8
3515,43,1,1,1,2,1,1,1,8
3516,43,1,1,2,1,1,1,1,8
3518,43,1,2,1,2,2,2,1,11
3520,43,2,2,1,2,1,2,1,11
3522,43,1,2,1,1,1,2,1,9
3526,43,2,2,1,2,1,2,1,11
3527,43,1,1,1,2,1,1,1,8
3528,43,1,2,1,1,1,1,1,8
3533,43,1,1,2,1,1,1,1,8
3535,43,2,2,1,2,1,2,1,11
3538,43,1,2,1,1,1,2,1,9
3546,43,1,1,2,1,1,1,1,8
3549,43,2,2,1,2,2,2,1,12
3562,43,1,2,1,1,1,2,1,9
3564,43,1,2,1,2,1,2,1,10
3567,43,1,1,1,1,1,1,2,8
3568,43,2,2,3,2,2,2,3,16
3569,43,2,2,1,2,1,2,1,11
3570,43,2,2,2,1,2,2,2,13
3571,43,2,1,1,1,1,1,1,8
3580,43,2,2,1,2,2,1,2,12
3581,43,1,1,1,2,1,1,1,8
3584,43,1,1,1,2,1,1,1,8
3585,43,1,2,1,1,1,2,1,9
3587,43,2,1,2,2,1,2,1,11
3588,43,1,2,1,1,1,2,1,9
3591,43,1,2,1,1,1,2,1,9
3596,43,2,2,1,2,2,1,2,12
3597,43,2,1,1,2,1,1,1,9
3601,43,3,2,2,2,2,2,2,15
3609,43,1,2,1,2,2,1,2,11
3611,43,2,2,2,2,2,2,2,14
3612,43,1,2,1,1,1,2,1,9
3616,43,1,2,1,1,2,1,1,9
3621,43,1,2,2,1,2,2,2,12
3623,43,2,1,2,1,2,1,1,10
3626,43,1,1,2,1,1,2,1,9
3633,43,1,2,1,1,2,1,2,10
3640,43,1,1,1,1,2,1,1,8
3641,43,2,1,1,2,1,2,1,10
3644,43,2,2,2,2,2,2,2,14
3645,43,1,2,2,1,2,1,2,11
3648,43,1,1,1,1,2,1,1,8
3650,43,1,2,1,1,1,2,1,9
3652,43,1,1,1,1,1,1,2,8
3658,43,1,1,1,2,1,1,1,8
3659,43,2,2,1,2,1,2,1,11
3660,43,1,2,1,1,1,2,1,9
3700,43,2,2,1,2,1,2,1,11
3701,43,2,1,2,1,2,1,1,10
3705,43,1,2,2,1,2,2,2,12
3709,43,1,1,1,1,2,1,1,8
3710,43,2,2,1,2,2,2,1,12
3722,43,2,2,1,2,2,2,1,12
3730,43,1,1,2,1,1,1,1,8
3731,43,2,2,2,2,2,2,1,13
3738,43,2,1,1,2,1,2,1,10
3739,43,1,1,1,1,1,1,2,8
3741,43,2,1,2,1,2,2,1,11
3742,43,2,2,2,2,1,2,2,13
3748,43,1,1,1,1,2,1,1,8
3750,43,2,2,1,2,2,2,1,12
3751,43,2,2,2,2,1,2,2,13
3754,43,1,1,1,1,1,1,2,8
3757,43,2,1,1,2,1,1,1,9
3763,43,1,2,1,1,1,2,1,9
3771,43,1,1,2,1,1,2,1,9
3773,43,1,1,2,1,1,2,1,9
3783,43,1,2,1,2,1,2,1,10
3785,43,2,2,1,2,1,2,1,11
3786,43,1,2,1,1,1,1,1,8
3790,43,1,1,1,2,1,1,1,8
3792,43,2,1,2,1,2,2,1,11
3795,43,2,1,2,2,2,1,2,12
3799,43,2,2,2,1,2,2,2,13
3803,43,2,2,2,1,2,2,1,12
3805,43,1,1,1,2,1,1,1,8
3829,43,1,2,1,1,1,2,1,9
3831,43,1,2,1,1,1,2,1,9
3833,43,1,1,2,1,1,1,1,8
3835,43,2,1,2,1,2,1,1,10
3838,43,1,1,2,1,1,1,1,8
3850,43,3,2,2,2,2,2,2,15
3851,43,2,2,1,2,1,2,1,11
3853,43,2,2,2,2,2,2,2,14
3860,43,2,2,2,2,2,2,2,14
3861,43,2,2,2,2,2,2,2,14
3864,43,2,1,2,2,1,2,1,11
3872,43,1,1,1,2,1,1,1,8
3874,43,2,1,1,2,1,1,1,9
3884,43,2,1,2,2,1,2,2,12
3886,43,2,1,2,1,2,1,2,11
3887,43,2,1,1,2,1,1,1,9
3888,43,1,2,1,1,1,2,1,9
3889,43,1,2,2,1,2,1,2,11
3891,43,1,1,2,1,1,1,1,8
3894,43,1,2,1,2,1,2,1,10
3897,43,2,2,2,2,2,2,2,14
3912,43,1,2,1,1,1,1,1,8
4055,43,2,2,1,2,2,2,1,12
4064,43,2,3,2,2,2,2,2,15
4068,43,1,2,2,1,1,1,1,9
4102,43,2,2,2,1,2,2,2,13
4103,43,2,3,3,2,3,3,3,19
4112,43,2,1,2,1,2,1,1,10
4115,43,2,1,2,1,1,2,1,10
4118,43,1,2,1,1,1,2,1,9
4129,43,2,2,1,2,1,2,1,11
4130,43,2,1,1,2,1,2,1,10
4131,43,2,2,1,2,2,2,1,12
4137,43,2,2,1,2,1,2,1,11
4144,43,2,2,2,1,2,2,1,12
4153,43,2,1,2,1,2,1,1,10
4156,43,2,2,2,1,2,2,1,12
4163,43,2,1,2,1,2,1,2,11
4166,43,2,1,2,2,2,1,2,12
4183,43,3,2,2,2,2,2,2,15
4195,43,2,2,2,2,2,3,2,15
4201,43,1,1,1,1,1,1,2,8
4219,43,2,2,1,2,2,2,1,12
4221,43,2,2,2,2,2,2,1,13
4224,43,3,2,2,2,3,2,2,16
4237,43,2,1,2,1,2,2,1,11
4239,43,2,1,2,1,1,2,1,10
4240,43,2,2,1,2,2,1,2,12
4243,43,1,2,1,1,2,1,2,10
4244,43,1,2,2,2,1,2,2,12
4250,43,2,2,1,2,2,2,2,13
4252,43,2,2,2,2,2,2,2,14
4253,43,2,1,2,2,1,2,1,11
4255,43,2,2,1,2,2,1,2,12
4257,43,3,2,2,3,2,2,2,16
4258,43,2,3,2,2,3,2,2,16
4260,43,2,1,2,1,1,2,1,10
4262,43,1,2,2,1,2,1,2,11
4272,43,2,1,2,2,1,2,1,11
4273,43,2,2,1,2,1,2,1,11
4274,43,2,1,2,1,2,1,1,10
4277,43,3,2,3,2,3,2,3,18
4285,43,2,1,2,2,1,2,2,12
4295,43,2,2,2,3,2,2,3,16
4298,43,1,2,2,1,2,2,2,12
4299,43,2,2,1,2,2,1,2,12
4303,43,2,2,1,2,2,2,1,12
4321,43,2,2,1,2,2,2,1,12
4325,43,1,2,1,2,1,2,1,10
4333,43,1,2,2,1,2,2,2,12
4334,43,2,2,1,2,2,1,2,12
4352,43,2,1,2,1,1,2,1,10
4356,43,1,2,1,2,1,2,1,10
4358,43,2,2,2,2,2,2,2,14
4365,43,2,1,2,2,2,2,2,13
4378,43,2,2,2,2,1,2,2,13
4381,43,2,2,2,1,2,2,1,12
4384,43,2,1,2,1,2,1,2,11
4387,43,1,2,1,2,2,1,2,11
4395,43,2,2,2,2,2,2,2,14
4403,43,2,1,2,2,1,2,1,11
4404,43,3,2,3,2,3,2,2,17
4410,43,1,2,1,2,1,2,2,11
4423,43,2,2,2,1,2,2,1,12
4424,43,1,2,1,2,1,2,2,11
4430,43,2,1,2,1,2,2,1,11
4436,43,2,2,2,2,2,1,2,13
4438,43,1,1,2,1,1,1,1,8
4444,43,2,1,2,1,2,2,1,11
4451,43,1,2,2,2,1,2,2,12
4459,43,2,2,1,2,1,2,1,11
4460,43,2,2,1,2,1,2,1,11
4472,43,2,2,1,2,2,1,2,12
4475,43,1,1,1,2,1,1,1,8
4479,43,2,2,1,2,1,2,1,11
4483,43,2,3,2,2,2,2,2,15
4484,43,1,2,1,1,2,1,2,10
4487,43,1,1,1,1,2,1,1,8
4506,43,1,1,2,1,1,2,1,9
4508,43,2,2,1,2,1,2,1,11
4526,43,2,2,2,2,2,2,2,14
4529,43,2,1,2,2,1,2,1,11
4531,43,2,1,2,1,2,1,2,11
4538,43,2,2,1,2,1,2,1,11
4553,43,2,2,1,2,2,2,1,12
4574,43,2,2,2,2,2,3,2,15
4581,43,2,1,2,2,1,2,2,12
4583,43,1,2,2,2,2,2,2,13
4593,43,2,2,1,2,2,2,1,12
4594,43,2,1,2,2,2,1,2,12
4601,43,1,2,2,2,1,2,2,12
4611,43,2,1,1,1,1,1,1,8
4615,43,1,2,2,2,2,2,2,13
4616,43,1,2,1,2,1,2,1,10
4623,43,2,2,2,2,2,2,3,15
4631,43,2,1,2,2,2,1,2,12
4638,43,1,2,2,2,2,2,2,13
4641,43,2,1,1,2,1,2,1,10
4644,43,2,2,2,2,2,2,1,13
4664,43,2,2,2,1,2,2,1,12
4678,43,2,2,2,1,2,2,1,12
4679,43,1,2,1,2,1,2,2,11
4697,43,2,2,2,2,2,2,1,13
4849,43,1,2,1,1,1,2,1,9
4865,43,2,2,1,2,2,1,2,12
5012,43,2,1,2,2,1,2,1,11
5023,43,2,2,2,1,2,2,1,12
5029,43,2,2,1,2,1,2,1,11
5035,43,2,2,2,2,2,2,1,13
5046,43,1,1,1,1,1,1,2,8
5054,43,1,1,1,1,2,1,1,8
5063,43,2,2,2,2,2,2,2,14
5065,43,1,2,1,1,1,2,1,9
5066,43,2,1,1,1,2,1,1,9
5070,43,2,1,2,1,2,1,1,10
5072,43,1,2,2,2,1,2,2,12
5076,43,2,3,2,2,2,2,2,15
5077,43,1,2,2,2,2,2,2,13
5078,43,1,1,1,1,1,1,2,8
5079,43,2,1,2,1,2,1,2,11
5085,43,1,1,1,2,1,1,2,9
5087,43,1,1,2,1,1,1,1,8
5095,43,1,1,2,1,1,2,1,9
5096,43,1,2,1,1,2,1,1,9
5099,43,2,1,2,1,2,1,2,11
5103,43,2,2,2,2,2,2,1,13
5104,43,1,2,2,2,2,2,2,13
5123,43,2,1,2,2,2,1,2,12
5124,43,1,2,1,2,2,1,2,11
5129,43,1,2,1,1,1,2,1,9
5130,43,1,2,1,2,1,1,2,10
5141,43,1,1,1,2,1,1,2,9
5145,43,1,1,2,1,1,2,1,9
5147,43,2,1,2,2,1,2,1,11
5151,43,1,2,1,2,2,1,2,11
5154,43,2,2,2,1,2,2,1,12
5155,43,2,2,2,1,2,2,2,13
5160,43,2,2,1,2,2,2,1,12
5165,43,2,1,2,1,2,1,1,10
5167,43,1,2,1,2,1,2,1,10
5173,43,1,1,1,1,1,1,2,8
5174,43,2,2,1,2,2,2,1,12
5184,43,2,1,1,1,2,1,1,9
5185,43,2,1,1,1,1,1,1,8
5189,43,1,2,1,1,1,2,1,9
5190,43,2,1,2,1,2,2,1,11
5193,43,2,1,2,2,1,2,2,12
5196,43,2,1,1,2,1,2,2,11
5197,43,2,2,2,2,2,1,2,13
5201,43,1,1,1,1,2,1,1,8
5202,43,2,1,2,2,1,2,2,12
5203,43,2,2,1,2,2,1,2,12
5211,43,1,2,1,2,1,2,1,10
5214,43,2,2,2,2,2,2,1,13
5216,43,1,2,2,2,2,2,2,13
5218,43,1,1,1,1,2,1,1,8
5220,43,1,1,2,1,1,2,1,9
5233,43,2,2,1,2,2,2,2,13
5234,43,2,1,2,1,2,1,1,10
5239,43,2,1,2,2,2,1,2,12
5241,43,2,1,2,2,1,2,2,12
5245,43,2,1,2,1,2,1,2,11
5247,43,2,2,2,2,2,2,1,13
5250,43,2,1,1,1,2,1,1,9
5252,43,2,1,2,1,2,1,1,10
5253,43,2,2,3,2,2,2,3,16
5254,43,2,2,2,2,2,2,2,14
5261,43,2,2,2,2,2,2,2,14
5262,43,2,2,2,2,2,2,2,14
5263,43,2,2,2,2,2,2,1,13
5264,43,1,2,1,1,1,2,1,9
5266,43,1,1,2,1,1,2,1,9
5270,43,2,2,1,2,2,2,1,12
5273,43,1,2,1,2,2,1,2,11
5275,43,1,2,1,1,2,1,1,9
5278,43,2,1,2,1,2,2,1,11
5281,43,1,2,1,2,2,1,2,11
5287,43,2,2,2,2,1,2,2,13
5292,43,2,1,2,1,2,2,1,11
5293,43,1,1,1,1,1,1,2,8
5295,43,2,2,2,2,2,2,1,13
5299,43,2,3,2,2,2,2,2,15
5300,43,1,2,1,1,2,1,1,9
5301,43,2,2,1,2,2,2,2,13
5303,43,1,2,1,1,1,2,1,9
5305,43,1,2,1,1,1,1,1,8
5307,43,1,2,1,2,1,1,2,10
5317,43,2,2,2,2,2,2,2,14
5325,43,2,2,2,2,2,2,2,14
5326,43,2,2,1,2,1,2,1,11
5329,43,2,2,2,2,2,2,1,13
5331,43,2,2,1,2,1,2,1,11
5334,43,1,1,1,2,1,1,1,8
5335,43,2,2,1,2,1,2,1,11
5337,43,2,2,2,2,2,2,2,14
5338,43,2,2,1,2,2,2,1,12
5342,43,2,2,2,2,2,2,2,14
5343,43,2,2,1,2,2,1,2,12
5348,43,2,1,2,2,1,2,1,11
5359,43,1,1,2,2,2,2,1,11
5361,43,2,2,1,2,2,2,1,12
5368,43,1,1,2,1,1,1,1,8
5369,43,2,2,1,2,2,2,2,13
5384,43,1,2,1,1,2,1,1,9
5385,43,2,1,2,2,1,2,1,11
5390,43,3,2,2,3,2,2,2,16
5391,43,2,1,2,2,2,1,2,12
5392,43,2,1,2,2,2,2,2,13
5397,43,2,2,2,2,1,2,2,13
5399,43,2,1,2,1,2,1,1,10
5402,43,2,2,1,2,1,2,1,11
5416,43,2,1,2,2,1,2,1,11
5419,43,1,1,1,1,2,1,1,8
5420,43,2,2,2,2,2,2,2,14
5422,43,2,1,1,2,1,1,1,9
5425,43,2,2,1,2,2,1,2,12
5428,43,2,1,2,2,2,2,2,13
5429,43,3,2,3,3,2,3,3,19
5430,43,1,2,2,1,2,1,2,11
5434,43,1,2,1,1,2,1,1,9
5435,43,2,1,2,2,2,2,2,13
5439,43,1,2,1,2,2,1,2,11
5441,43,2,2,2,2,2,2,2,14
5443,43,2,2,1,2,2,2,1,12
5445,43,2,2,2,2,2,2,1,13
5446,43,1,2,1,1,1,2,1,9
5447,43,1,2,1,1,2,1,1,9
5448,43,1,2,1,2,2,1,2,11
5460,43,2,1,2,2,2,1,2,12
5461,43,2,2,2,1,2,2,1,12
5466,43,2,2,2,2,2,2,2,14
5470,43,2,1,2,2,2,1,2,12
5477,43,1,1,2,1,1,1,1,8
5479,43,1,2,2,1,2,1,2,11
5482,43,1,2,2,2,2,2,2,13
5485,43,1,2,1,1,2,1,2,10
5487,43,1,2,1,1,1,2,1,9
5488,43,1,1,2,1,1,1,1,8
5491,43,2,2,1,2,1,2,1,11
5494,43,2,1,2,2,1,2,2,12
5495,43,2,1,2,2,1,2,2,12
5497,43,2,1,2,2,1,2,2,12
5499,43,2,1,2,2,2,2,2,13
5617,43,1,2,1,2,1,2,2,11
5626,43,2,1,1,2,1,1,1,9
5632,43,2,2,1,2,2,2,1,12
5644,43,1,2,2,2,1,2,2,12
5671,43,1,2,1,2,2,1,2,11
5672,43,1,1,1,2,1,1,1,8
5686,43,1,1,1,1,1,1,2,8
5706,43,2,2,1,2,1,2,1,11
5707,43,1,2,1,1,2,1,1,9
5709,43,1,1,1,2,1,1,1,8
5713,43,2,2,2,2,2,2,2,14
5717,43,2,2,2,2,2,2,2,14
5728,43,1,2,1,2,2,1,2,11
5735,43,2,1,1,2,1,1,1,9
5752,43,2,1,2,1,2,2,1,11
5753,43,2,2,2,1,2,2,2,13
5764,43,1,1,1,1,2,1,1,8
5779,43,1,2,1,2,1,2,2,11
5787,43,2,2,1,2,2,2,1,12
5797,43,1,1,2,1,1,1,1,8
5808,43,2,1,2,2,2,2,2,13
5809,43,2,2,1,2,2,2,1,12
5812,43,2,2,1,2,2,2,2,13
5842,43,1,2,1,1,2,1,2,10
5844,43,2,2,1,2,1,2,1,11
5845,43,2,2,1,2,2,2,1,12
5847,43,2,2,1,2,2,1,2,12
5851,43,2,1,1,1,1,1,1,8
5861,43,1,2,1,1,2,1,2,10
5867,43,2,2,2,1,2,2,1,12
5869,43,2,1,2,1,1,2,1,10
5872,43,1,1,1,1,1,1,2,8
5879,43,1,2,2,2,1,2,2,12
5881,43,1,2,1,1,1,1,1,8
5882,43,1,2,1,2,2,1,2,11
5883,43,2,2,2,1,2,2,1,12
5894,43,2,2,1,2,1,2,1,11
5932,43,1,1,1,1,1,1,2,8
5947,43,2,3,2,2,2,2,2,15
5959,43,1,2,1,1,1,1,1,8
5964,43,2,2,2,2,2,2,2,14
5968,43,2,1,2,2,2,1,2,12
5977,43,2,2,1,2,2,1,2,12
6190,43,2,2,1,2,1,2,1,11
6467,43,1,2,1,1,1,1,1,8
6469,43,2,1,1,2,1,2,1,10
6576,43,2,2,1,2,1,2,1,11
6789,43,1,1,1,2,1,1,2,9
6807,43,2,1,2,2,2,1,2,12
6878,43,3,2,2,2,2,2,2,15
6879,43,1,1,2,1,1,1,1,8
6898,43,2,2,1,2,2,2,1,12
6958,43,2,1,1,2,1,2,1,10
6963,43,1,1,1,1,1,1,2,8
7032,43,2,1,2,2,1,2,1,11
7181,43,1,2,1,1,2,1,2,10
7194,43,1,1,1,1,2,1,1,8
7301,43,2,1,2,1,2,1,1,10
7324,43,1,2,1,1,1,1,1,8
8331,43,1,2,1,1,1,1,1,8
